!	PUNCT	_
!//	PUNCT	_
!//]	PUNCT	_
!//=	PUNCT	_
!]	PUNCT	_
!=	PUNCT	_
#	PUNCT	_
&	X	_
(	PUNCT	_
)	PUNCT	_
//	PUNCT	_
//)	PUNCT	_
//]	PUNCT	_
//+	PUNCT	_
//=	PUNCT	_
?	PUNCT	_
?//	PUNCT	_
?//]	PUNCT	_
?//=	PUNCT	_
?]	PUNCT	_
?=	PUNCT	_
[	PUNCT	_
[eng	PUNCT	_
[hau	PUNCT	_
[igb	PUNCT	_
[yor	PUNCT	_
]	PUNCT	_
{	PUNCT	_
|	PUNCT	_
||	PUNCT	_
||r	PUNCT	_
|a	PUNCT	_
|c	PUNCT	_
|r	PUNCT	_
}	PUNCT	_
+	PUNCT	_
<	PUNCT	_
<+	PUNCT	_
=	PUNCT	_
>	PUNCT	_
>+	PUNCT	_
a	DET	Def=Ind|PronType=Art  
a	PRON	Case=Nom|Number=Sing|Person=1|PronType=Prs 
a'ah	INTJ	_
ab-	X	_
abeg	INTJ	_
abegi	INTJ	_
Abel	PROPN	_
abi	CCONJ	_
about	ADP	_
above	ADP	_
abroad	ADV	_
Abuja	PROPN	_
Abuja's	PROPN	_
abuse	NOUN	_
AC	NOUN	_
accept	VERB	_
according	VERB	Tense=Pres|VerbForm=Part
accountable	NOUN	_
acha	NOUN	_
achieve	VERB	_
act	VERB	_
action	NOUN	_
activities	NOUN	Number=Plur
activity	NOUN	_
actually	ADV	_
add	VERB	_
adding	VERB	Tense=Pres|VerbForm=Part
Adeja	PROPN	_
Adigo	NOUN	_
adjust	VERB	_
admin	ADJ	_
admin	NOUN	_
admire	VERB	_
admission	NOUN	_
adopt	VERB	_
adoption	NOUN	_
adult	NOUN	_
advantage	NOUN	_
advi-	VERB	_
advice	NOUN	_
advise	VERB	_
adviser	NOUN	_
afford	VERB	_
affordable	ADJ	_
African	ADJ	_
aft-	X	_
after	ADP	_
afternoon	NOUN	_
again	ADV	_
Agbadu	PROPN	_
age	NOUN	_
ago	ADV	_
Agofure	PROPN	_
Agofure	NOUN	_
agreement	NOUN	_
Agwandodo	PROPN	_
ah	INTJ	_
aha	INTJ	_
ahah	INTJ	_
ahan	INTJ	_
ahead	ADV	_
ahi	INTJ	_
aim	NOUN	_
ak-	X	_
akara	NOUN	_
al-	X	_
Ala-	PROPN	_
alap-	X	_
Alaska	PROPN	_
alcohol	NOUN	_
Alhaji	PROPN	_
alive	ADJ	_
all	ADV	_
Alleviation	PROPN	_
all-night	NOUN	_
allow	VERB	_
allowances	NOUN	Number=Plur
almo-	X	_
almost	ADV	_
alone	ADJ	_
along	ADP	_
already	ADV	_
alright	ADV	_
also	ADV	_
aluminium	NOUN	_
always	ADV	_
am	AUX	Mood=Ind|Number=Sing|Person=1|Tense=Pres|VerbForm=Fin 
am	PRON	Case=Acc|Number=Sing|Person=3|PronType=Prs 
Amaka	PROPN	_
amala	NOUN	_
amawe	X	_
ambition	NOUN	_
amen	INTJ	_
America	PROPN	_
among	ADP	_
amount	NOUN	_
an	DET	Def=Ind|PronType=Art 
and	CCONJ	_
Andrew	PROPN	_
Anfield	PROPN	_
angel	NOUN	_
angle	NOUN	_
angry	ADJ	_
animal	NOUN	_
animal	ADJ	_
animals	NOUN	Number=Plur
Ankwai	PROPN	_
annoying	ADJ	_
anoda	DET	_
anoder	DET	_
another	DET	_
answer	VERB	_
anti	ADJ	_
any	DET	_
anyb-	PRON	_
anybody	PRON	_
anyhow	ADV	_
anymore	ADV	_
anyone	PRON	_
anything	PRON	_
anytime	ADV	_
anytin	PRON	_
anyting	PRON	_
anyway	ADV	_
anywhere	ADV	_
apart	ADV	_
appear	VERB	_
appetite	NOUN	_
application	NOUN	_
ar-	X	_
are	AUX	Mood=Ind|Number=Plur|Tense=Pres|VerbForm=Fin  Lemma: be (CS) 
area	X	_
area	NOUN	_
argue	VERB	_
armed	ADJ	_
Army	NOUN	_
army	NOUN	_
aroma	NOUN	_
around	ADP	_
arrange	VERB	_
arrest	VERB	_
arrive	VERB	_
arrow	NOUN	_
Arsenal	NOUN	_
Arsenal	PROPN	_
Arsene	PROPN	_
artworks	NOUN	Number=Plur
as	ADP	_
Aseginmba	PROPN	_
asewo	NOUN	_
Asian	NOUN	_
Asian	ADJ	_
aside	NOUN	_
aside	ADP	_
ask	VERB	_
aspect	NOUN	_
assignment	NOUN	_
ASUU	PROPN	_
at	ADP	_
atimes	ADV	_
attend	VERB	_
attitude	NOUN	_
attract	VERB	_
audition	VERB	_
Augustus	PROPN	_
Aunty	PROPN	_
aunty	NOUN	_
aw-	X	_
aya	NOUN	_
b-	X	_
ba	PART	_
ba	X	_
ba-	X	_
Baba	PROPN	_
babe	NOUN	_
babes	NOUN	Number=Plur
baby	NOUN	_
back	ADV	_
back	NOUN	_
backyard	NOUN	_
bad	ADJ	_
bag	PRON	_
bah	INTJ	_
balance	VERB	_
balanced	VERB	Mood=Ind|Tense=Past|VerbForm=Fin 
ball	NOUN	_
ban-	X	_
banga	NOUN	_
bank	NOUN	_
baptise	VERB	_
baptism	NOUN	_
Baptist	PROPN	_
bar	NOUN	_
barbing	NOUN	_
barrow	NOUN	_
Bartolemew	PROPN	_
base	NOUN	_
basically	ADV	_
bastard	NOUN	_
bath	VERB	_
bathroom	NOUN	_
battering	NOUN	_
battle	VERB	_
Bayelsa	PROPN	_
Bayern	PROPN	_
BCG	NOUN	_
be	VERB	PartType=Cop 
beans	NOUN	Number=Plur
beat	VERB	_
beater	NOUN	_
beating	VERB	Tense=Pres|VerbForm=Part
beating	NOUN	_
beautiful	ADJ	_
beautifully	ADV	_
because	SCONJ	_
become	VERB	_
becomes	VERB	Mood=Ind|Number=Sing|Person=3|Tense=Pres|VerbFor=Fin 
bed	NOUN	_
been	AUX	_
beer	NOUN	_
before	ADP	_
beg	VERB	_
begin	VERB	_
beginning	NOUN	_
begins	VERB	Mood=Ind|Number=Sing|Person=3|Tense=Pres|VerbFor=Fin 
behave	VERB	_
being	VERB	_
beings	NOUN	Number=Plur
bele	NOUN	_
belief	NOUN	_
believe	VERB	_
belle	NOUN	_
Belt	PROPN	_
benefit	VERB	_
Benin	PROPN	_
Berom	PROPN	_
Berries	PROPN	_
beside	ADP	_
best	ADJ	Degree=Sup
bet	NOUN	_
beta	ADJ	Degree=Comp
betray	VERB	_
better	ADJ	Degree=Comp
betterment	NOUN	_
betting	NOUN	_
between	ADP	_
Biafra	PROPN	_
Bible	PROPN	_
big	ADJ	_
bike	NOUN	_
biko	X	_
bill	NOUN	_
billion	NUM	_
billionaire	NOUN	_
bin	AUX	AUX  Tense=Past 
birth	NOUN	_
birthday	NOUN	_
biscuit	NOUN	_
bit	NOUN	_
bitter	ADJ	_
bla	INTJ	_
black	ADJ	_
blame	NOUN	_
blame	VERB	_
bleach	VERB	_
blender	NOUN	_
bless	VERB	_
block	VERB	_
block	NOUN	_
blocvide?	PUNCT	_
blood	NOUN	_
blow	VERB	_
boarders	NOUN	Number=Plur
boarding	NOUN	_
body	NOUN	_
boil	VERB	_
boils	VERB	Mood=Ind|Number=Sing|Person=3|Tense=Pres|VerbFor=Fin 
Boko	PROPN	_
boku	ADV	_
bomboy	NOUN	_
bone	NOUN	_
bones	NOUN	Number=Plur
book	NOUN	_
born	VERB	_
borrow	VERB	_
bottle	NOUN	_
bought	VERB	Mood=Ind|Tense=Past|VerbForm=Fin 
bound	VERB	_
boutique	NOUN	_
bow	VERB	_
bow	NOUN	_
bowl	NOUN	_
boy	INTJ	_
boy	NOUN	_
boyfriend	NOUN	_
boys	NOUN	Number=Plur
Boys	PROPN	Number=Plur
brain	NOUN	_
bread	NOUN	_
break	NOUN	_
break	X	_
break	VERB	_
breastfeed	VERB	_
breastfeeding	NOUN	_
breastmilk	NOUN	_
breeze	VERB	_
bride	NOUN	_
briefly	ADV	_
brin-	X	_
bring	VERB	_
bro	NOUN	_
bro-	X	_
bro-	NOUN	_
broadcast	VERB	_
broadcasting	NOUN	_
broda	NOUN	_
broder	NOUN	_
broders	NOUN	Number=Plur
bros	NOUN	_
brother	NOUN	_
brown	ADJ	_
browse	VERB	_
brush	VERB	_
brutalise	VERB	_
budget	VERB	_
Buhari	PROPN	_
build	VERB	_
building	NOUN	_
Bukuru	PROPN	_
bulldozer	NOUN	_
bullet	NOUN	_
bunkering	NOUN	_
burial	NOUN	_
burkutu	NOUN	_
burn	VERB	_
bury	VERB	_
bus	NOUN	_
bush	NOUN	_
business	NOUN	_
bustop	NOUN	_
busy	ADJ	_
but	CCONJ	_
buy	VERB	_
buying	VERB	_
by	ADP	_
c-	X	_
ca-	VERB	_
Cab	PROPN	_
Caesar	PROPN	_
cafe	NOUN	_
Cain	PROPN	_
calabash	NOUN	_
call	NOUN	_
call	VERB	_
calm	VERB	_
calm	ADJ	_
camera	NOUN	_
campaign	VERB	_
Camry	PROPN	_
can	AUX	_
cap	VERB	_
cap	NOUN	_
Capital	PROPN	_
car	NOUN	_
card	NOUN	_
care	NOUN	_
care	VERB	_
careful	ADJ	_
Caroline	PROPN 	_
carpenter	NOUN	_
carry	VERB	_
carton	NOUN	_
case	NOUN	_
casement	NOUN	_
cassava	NOUN	_
catapult	NOUN	_
catch	VERB	_
Catholic	ADJ	_
cause	VERB	_
cause	SCONJ	_
celebrate	VERB	_
cement	NOUN	_
centre	NOUN	_
certain	ADJ	_
chai	INTJ	_
chair	NOUN	_
chairman	NOUN	_
challenge	VERB	_
challenge	NOUN	_
challenges	NOUN	Number=Plur
Champion	PROPN	_
Champion's	NOUN	_
chance	NOUN	_
change	VERB	_
change	NOUN	_
channel	VERB	_
chapter	NOUN	_
charcoal	NOUN	_
charge	VERB	_
charge	NOUN	_
Charity	PROPN	_
charity	NOUN	_
charter	VERB	_
chat	VERB	_
chatting	NOUN	_
Che-	X	_
cheap	ADJ	_
cheat	VERB	_
cheating	NOUN	_
checheche	X	_
check	NOUN	_
check	VERB	_
checklist	NOUN	_
Chelsea	PROPN	_
chey	INTJ	_
chi	INTJ	_
chi-	NOUN	_
Chibozor	PROPN	_
chicken	NOUN	_
chief	NOUN	_
Chilaka	PROPN	_
childhood	NOUN	_
children	NOUN	Number=Plur 
chin	NOUN	_
chinchin	NOUN	_
Chioma	PROPN	_
cho	NOUN	_
choice	NOUN	_
chook	VERB	_
chop	VERB	_
chop	NOUN	_
Chris	PROPN	_
Christ	PROPN	_
Christian	ADJ	_
Christianity	NOUN	_
Christmas	PROPN	_
Christopher	PROPN	_
chuku	VERB	_
church	NOUN	_
Church	PROPN	_
circle	NOUN	_
circumcise	VERB	_
citizen	NOUN	_
citizens	NOUN	Number=Plur
City	PROPN	_
city	NOUN	_
Civil	PROPN	_
civil	ADJ	_
civilisation	NOUN	_
claim	VERB	_
class	NOUN	_
clean	ADJ	_
clear	VERB	_
clear	ADJ	_
clever	ADJ	_
click	VERB	_
climb	VERB	_
close	VERB	_
closer	ADJ	Degree=Cmp 
cloth	NOUN	_
cloth	VERB	_
club	NOUN	_
co-	X	_
coach	NOUN	_
coffin	NOUN	_
cold	ADJ	_
collaborate	VERB	_
collaboration	NOUN	_
colleague	NOUN	_
colleagues	NOUN	Number=Plur 
collect	VERB	_
colour	NOUN	_
combine	VERB	_
come	AUX	Aspect=Real 
come	VERB	_
comes	VERB	Mood=Ind|Number=Sing|Person=3|Tense=Pres|VerbFor=Fin 
comfortable	ADJ	_
coming	VERB	Tense=Pres|VerForm=Part
Commitee	PROPN	_
common	ADJ	_
community	NOUN	_
comot	VERB	_
company	NOUN	_
compare	VERB	_
complain	VERB	_
complain	NOUN	_
complaint	NOUN	_
complete	VERB	_
complete	ADJ	_
complimentary	NOUN	_
compound	NOUN	_
computer	NOUN	_
con	AUX	Aspect=Real 
con-	X	_
concern	VERB	_
confess	VERB	_
confirm	VERB	_
conne-	VERB	_
connect	VERB	_
connection	NOUN	_
contest	VERB	_
continue	VERB	_
contract	NOUN	_
contribute	VERB	_
contribution	NOUN	_
control	VERB	_
control	NOUN	_
controlling	VERB	Tense=Pres|VerbForm=Part
convalescence	NOUN	_
convenient	ADJ	_
conventional	ADJ	_
cook	VERB	_
cooking	VERB	Tense=Pres|VerbForm=Part
cool	VERB	_
Cool	PROPN	_
cooler	NOUN	_
corn	NOUN	_
corner	NOUN	_
corners	NOUN	Number=Plur 
cornflakes	NOUN	Number=Plur 
corpers	NOUN	Number=Plur 
correct	VERB	_
correct	ADJ	_
corrupt	ADJ	_
corruption	NOUN	_
cos	CCONJ	_
cost	VERB	_
Cotonou	PROPN	_
coun	X	_
countries	NOUN	Number=Plur
country	VERB	_
country	NOUN	_
course	NOUN	_
courtship	NOUN	_
cousin	NOUN	_
cover	VERB	_
cow	NOUN	_
cows	NOUN	Number=Plur
crack	VERB	_
crash	VERB	_
crate	VERB	_
crawl	VERB	_
crayfish	NOUN	_
cre-	X	_
create	VERB	_
creche	NOUN	_
creche	PRON	_
credits	NOUN	Number=Plur
crime	NOUN	_
cross	NOUN	_
cross	VERB	_
cruise	VERB	_
cry	VERB	_
Crystal	PROPN	_
cu-	X	_
cultural	ADJ	_
culture	NOUN	_
cure	VERB	_
custard	NOUN	_
customer	NOUN	_
customers	NOUN	Number=Plur 
cut	VERB	_
cutlass	NOUN	_
cutters	NOUN	Number=Plur 
cyber	ADJ	_
D-	X	_
d-	X	_
da	X	_
da-	X	_
dabino	NOUN	_
dad	NOUN	_
daddy	NOUN	_
dan	ADP	_
dance	VERB	_
Dangote	PROPN	_
dat	DET	Number=Sing|PronType=Dem 
dat	PRON	Number=Sing|PronType=Dem 
dat	SCONJ	_
date	VERB	_
dats	PART	_
dat's	PART	_
daughter	NOUN	_
daughters	NOUN	Number=Plur 
dawadawa	NOUN	_
day	NOUN	_
daybreak	NOUN	_
days	NOUN	Number=Plur
daze	VERB	_
de	PRON	Case=Nom|Number=Plur|Person=3|PronType=Prs 
de-	X	_
dead	NOUN	_
deal	NOUN	_
dear	ADJ	_
debate	NOUN	_
December	PROPN	_
decide	VERB	_
decrease	VERB	_
Defence	PROPN	_
Defence	PROPN 	_
defence	NOUN	_
defense	NOUN	_
definitely	ADV	_
deir	ADJ	Number=Plur|Person=3|Poss=Yes|PronType=Prs 
delay	VERB	_
deliver	VERB	_
delivery	NOUN	_
Delta	PROPN	_
dem	DET	Number=Plur 
dem	PRON	Case=Nom|Number=Plur|Person=3|PronType=Prs 
dem	PRON	Case=Acc|Number=Plur|Person=3|PronType=Prs 
demolition	NOUN	_
demoralisation	NOUN	_
demoralising	ADJ	_
demsef	PRON	Case=Acc|Number=Plur|Person=3|PronType=Pers|Reflex=Yes 
demsefs	PRON	Case=Acc|Number=Plur|Person=3|PronType=Pers|Reflex=Yes 
demself	PRON	Case=Acc|Number=Plur|Person=3|PronType=Pers|Reflex=Yes 
den	ADV	_
dent	VERB	_
deodorants	NOUN	Number=Plur
department	NOUN	_
depend	VERB	_
depends	VERB	Mood=Ind|Number=Sing|Person=3|Tense=Pres|VerbFor=Fin 
dere	ADV	PronType=Dem 
describe	VERB	_
dese	DET	Number=Plur|PronType=Dem 
deserve	VERB	_
design	VERB	_
destroy	VERB	_
detail	NOUN	_
develop	VERB	_
developed	VERB	Tense=Past|VerbForm=Part 
development	NOUN	_
Devil	PROPN	_
devil's	NOUN	_
dey	VERB	PartType=Cop 
dey	AUX	Aspect=Imp 
di	DET	Definite=Def|PronType=Art 
diabetes	NOUN	_
diabetic	ADJ	_
dictionary	NOUN	_
did	AUX	Mood=Ind|Tense=Past|VerbForm=Fin 
die	VERB	_
diet	NOUN	_
differ	VERB	_
difference	NOUN	_
different	ADJ	_
differently	ADV	_
difficult	ADJ	_
dip	VERB	_
diploma	NOUN	_
direction	NOUN	_
dirty	ADJ	_
dis	PRON	Number=Sing|PronType=Prox 
dis	DET	Number=Sing|PronType=Prox 
disciple	NOUN	_
discover	VERB	_
discuss	VERB	_
discussion	NOUN	_
disgrace	VERB	_
disgrace	NOUN	_
dish	NOUN	_
dismantle	VERB	_
disturb	VERB	_
divide	VERB	_
division	NOUN	_
DNA	NOUN	_
do	VERB	_
doctor	NOUN	_
doctorate	NOUN	_
doctors	NOUN	Number=Plur 
document	NOUN	_
documentation	NOUN	_
dog	NOUN	_
doing	VERB	Tense=Pres|VerbForm=Part 
domestic	ADJ	_
don	AUX	Aspect=Perf 
donate	VERB	_
done	VERB	Tense=Past|VerbForm=Part
dont	AUX	_
don't	AUX	_
door	NOUN	_
dormot	NOUN	_
dose	PRON	Number=Plur|PronType=Dem 
dose	DET	Number=Plur|PronType=Dem 
dough	SCONJ	_
down	ADP	_
Dr	PROPN	_
drag	VERB	_
drama	PART	_
draw	VERB	_
dress	VERB	_
drink	VERB	_
drink	NOUN	_
drinks	NOUN	Number=Plur 
drive	VERB	_
driver	NOUN	_
drop	NOUN	_
drop	VERB	_
dry	ADJ	_
during	ADP	_
e	ADJ	Number=Sing|Person=3|Poss=Yes|PronType=Prs 
e	PRON	Case=Nom|Number=Sing|Person=3|PronType=Prs 
e-	X	_
ea	X	_
each	DET	_
ear	NOUN	_
early	ADJ	_
earth	NOUN	_
ease	VERB	_
East	PROPN	_
Easter	PROPN	_
easy	ADJ	_
eat	VERB	_
eating	NOUN	_
eba	NOUN	_
Eckankar	PROPN	_
economy	NOUN	_
edge	NOUN	_
Edo	PROPN	_
education	NOUN	_
eeh	INTJ	_
Efuru	PROPN	_
egg	NOUN	_
eggs	NOUN	Number=Plur
egusi	NOUN	_
eh	INTJ	_
eh	VERB	_
ehe	INTJ	_
eheh	INTJ	_
ehen	INTJ	_
ehm	INTJ	_
ehn	INTJ	_
eida	CCONJ	_
eight	NUM	NumType=Card 
eighty	NUM	NumType=Card 
either	CCONJ	_
Ekpoma	PROPN	_
elder	ADJ	Degree=Cmp 
elders	NOUN	Number=Plur
eldest	ADJ	Degree=Sup 
elect-	NOUN	_
election	NOUN	_
electrical	ADJ	_
electrician	NOUN	_
elephant	NOUN	_
eleven	NUM	NumType=Card 
else	ADJ	_
em	INTJ	_
embrace	VERB	_
eme	X	_
emi	INTJ	_
Emirate	PROPN	_
employ	VERB	_
empowerment	NOUN	_
en	INTJ	_
encounter	NOUN	_
encourage	VERB	_
end	NOUN	_
end	VERB	_
ending	VERB	Tense=Pres|VerbForm=Part 
eng]	PUNCT	_
engineer	NOUN	_
engineering	NOUN	_
England	PROPN	_
English	NOUN	_
English	PROPN	_
enjoy	VERB	_
enjoyment	NOUN	_
enough	ADV	_
enough	ADJ	_
enquiry	VERB	_
enter	VERB	_
entering	VERB	Tense=Pres|VerbForm=Part
entertain	NOUN	_
entertain	VERB	_
entertainment	NOUN	_
entirely	ADV	_
entrance	NOUN	_
Enugu	PROPN	_
Enyan	PROPN	_
equal	VERB	_
equality	NOUN	_
equally	ADV	_
Esan	PROPN	_
escort	VERB	_
especially	ADV	_
establish	NOUN	_
Esther	PROPN	_
eth-	X	_
ethnicity	NOUN	_
Etima	PROPN	_
Etsako	PROPN	_
Europa	PROPN	_
Europe	PROPN	_
ev	X	_
ev-	X	_
ev-	VERB	_
even	ADV	_
evening	NOUN	_
ever	ADV	_
every	DET	_
everybody	PRON	_
everyday	ADV	_
everything	PRON	_
everytime	ADV	_
everytin	PRON	_
everyting	PRON	_
everywhere	ADV	_
eveybody	PRON	_
ewa	NUM	_
exa-	X	_
exact	ADJ	_
exactly	ADV	_
exam	NOUN	_
examination	NOUN	_
example	NOUN	_
except	ADP	_
exchange	VERB	_
exclusive	ADJ	_
expatriate	NOUN	_
expect	VERB	_
expensive	ADJ	_
experience	NOUN	_
explain	VERB	_
explained	VERB	Mood=Ind|Tense=Past|VerbForm=Fin 
explore	VERB	_
export	VERB	_
exposed	VERB	Tense=Past|VerbForm=Part|Voice=Pass
extend	VERB	_
extent	NOUN	_
extra	NOUN	_
ey	INTJ	_
eye	NOUN	_
eyes	NOUN	Number=Plur 
f	X	_
f-	X	_
f-	INTJ	_
f-	PART	_
FA	PROPN	_
face	NOUN	_
face	VERB	_
Facebook	PROPN	_
fact	NOUN	_
fada	NOUN	_
fader	NOUN	_
faders	NOUN	Number=Plur
fail	VERB	_
faith	NOUN	_
faithful	ADJ	_
fall	VERB	_
family	NOUN	_
far	ADV	_
farm	NOUN	_
farm	VERB	_
farmer	NOUN	_
fashion	NOUN	_
fashionable	ADJ	_
fast	ADJ	_
fast	VERB	_
fat	ADJ	_
fateful	ADJ	_
father	NOUN	_
fault	NOUN	_
favour	VERB	_
favourable	ADJ	_
fe	X	_
fear	VERB	_
Federal	PROPN	_
feed	VERB	_
feedback	NOUN	_
feeding	NOUN	_
feel	VERB	_
fees	NOUN	Number=Plur 
felle-	X	_
fellow	ADJ	_
female	NOUN	_
females	NOUN	Number=Plur 
feminism	NOUN	_
feminist	NOUN	_
feminist	ADJ	_
festival	NOUN	_
fetch	VERB	_
fi	X	_
fi-	ADP	_
fibroid	NOUN	_
fidelity	NOUN	_
fifth	NUM	NumType=Ord 
fifty	NUM	NumType=Card 
fight	VERB	_
fight	NOUN	_
film	NOUN	_
filter	VERB	_
filter	NOUN	_
final	ADJ	_
finally	ADV	_
finance	NOUN	_
find	VERB	_
fine	ADJ	_
finish	VERB	_
fire	NOUN	_
firewood	NOUN	_
first	ADJ	NumType=Ord 
first	ADV	_
fish	VERB	_
fish	NOUN	_
fit	AUX	_
five	NUM	NumType=Card 
five-one	NOUN	_
flat	NOUN	_
flavour	NOUN	_
flow	VERB	_
FM	PROPN	_
focus	VERB	_
follow	VERB	_
followers	NOUN	Number=Plur 
following	ADJ	_
food	NOUN	_
football	NOUN	_
for	AUX	Mood=Cond 
for	ADP	_
force	VERB	_
force	NOUN	_
fore	NOUN	_
fore-	X	_
forefader	NOUN	_
foreigner	NOUN	_
forest	NOUN	_
forget	VERB	_
forgive	VERB	_
form	VERB	_
form	NOUN	_
former	ADJ	_
formula	NOUN	_
fortunately	ADV	_
forty	NUM	NumType=Card 
forward	ADV	_
forward	VERB	_
found	VERB	Mood=Ind|Tense=Past|VerbForm=Fin 
four	NUM	NumType=Card 
fourteen	NUM	NumType=Card
fourth	ADJ	NumType=Ord 
free	VERB	_
free	ADJ	_
freedom	NOUN	_
freeze	VERB	_
French	PROPN	_
French	ADJ	_
fresh	ADJ	_
fridge	NOUN	_
friend	NOUN	_
friend	VERB	_
friendly	ADJ	_
friends	NOUN	Number=Plur 
from	ADP	_
front	NOUN	_
fry	VERB	_
fry	ADJ	_
frying	ADJ	_
fuck	VERB	_
fuckup	NOUN	_
fuckup	VERB	_
fuel	NOUN	_
full	VERB	_
full	ADJ	_
fully	ADV	_
fur-	X	_
further	ADV	_
future	NOUN	_
gada	VERB	_
gader	VERB	_
gain	NOUN	_
gan	ADV	_
gangan	ADV	_
garage	NOUN	_
garbage	NOUN	_
garden	NOUN	_
garri	NOUN	_
gas	NOUN	_
gaskiya	NOUN	_
gate	NOUN	_
gather	VERB	_
gats	ADV	_
gbogbo	NOUN	_
gbosa	NOUN	_
ge-	VERB	_
General	PROPN	_
generally	ADV	_
generation	NOUN	_
germs	NOUN	Number=Plur
get	VERB	_
getting	VERB	Tense=Pres|VerbForm=Part 
ghetto	NOUN	_
gi-	X	_
gidi	NOUN	_
gifts	NOUN	Number=Plur
ginger	VERB	_
girl	NOUN	_
girlfriend	NOUN	_
girls	NOUN	Number=Plur 
give	VERB	_
giving	VERB	Tense=Pres|VerbForm=Part 
glass	NOUN	_
glory	NOUN	_
go	AUX	Tense=Prosp 
go	VERB	_
Go-	X	_
goat	NOUN	_
God	PROPN	_
god	NOUN	_
goes	VERB	Mood=Ind|Number=Sing|Person=3|Tense=Pres|VerbFor=Fin 
going	VERB	Tense=Pres|VerbForm=Part 
gold	NOUN	_
Golden	PROPN	_
good	ADJ	_
Goodluck	PROPN	_
goods	NOUN	_
gote	NOUN	_
gover-	X	_
government	NOUN	_
governor	NOUN	_
governors	NOUN	Number=Plur 
gown	NOUN	_
grab	VERB	_
grace	NOUN	_
grade	NOUN	_
graduate	NOUN	_
graduate	VERB	_
gragra	ADJ	_
gragra	NOUN	_
gram	NOUN	_
grammar	NOUN	_
Grand	PROPN	_
grand	NOUN	_
grand-	X	_
Grandma	PROPN	_
grassroot	NOUN	_
gree	VERB	_
greed	NOUN	_
greedy	ADJ	_
green	ADJ	_
greet	VERB	_
grind	VERB	_
grinding	NOUN	_
ground	NOUN	_
groundnut	NOUN	_
groundnuts	NOUN	Number=Plur
group	NOUN	_
grow	VERB	_
gruel	NOUN	_
guard	VERB	_
gun	NOUN	_
Gunners	PROPN	_
Guru	PROPN	_
guy	NOUN	_
guyman	NOUN	_
guys	NOUN	Number=Plur 
Gwagwalada	PROPN	_
Gwanga	PROPN	_
ha	INTJ	_
haba	INTJ	_
Hadejia	PROPN	_
hah	INTJ	_
haha	INTJ	_
hail	VERB	_
hair	NOUN	_
hairdressing	NOUN	_
hala	VERB	_
half	ADJ	_
hand	NOUN	_
handle	VERB	_
hands	NOUN	Number=Plur 
handwork	NOUN	_
hanger	NOUN	_
hangout	NOUN	_
hangout	VERB	_
happen	VERB	_
happy	ADJ	_
Haram	PROPN	_
Harcourt	PROPN	_
hard	ADJ	_
hardworking	ADJ	_
harsh	ADJ	_
has	VERB	Mood=Ind|Number=Sing|Person=3|Tense=Pres|VerbForm=Fin|
hate	VERB	_
hau]	PUNCT	_
Hausa	PROPN	_
have	VERB	_
hawk	VERB	_
he	PRON	Case=Nom|Number=Sing|Person=3|PronType=Prs 
head	NOUN	_
headache	NOUN	_
headway	NOUN	_
healing	NOUN	_
healings	NOUN	Number=Plur
health	NOUN	_
healthy	ADJ	_
hear	VERB	_
heart	NOUN	_
heat	NOUN	_
heaven	NOUN	_
heh	INTJ	_
hehe	INTJ	_
hello	INTJ	_
help	VERB	_
hen	INTJ	_
hence	ADV	_
her	ADJ	Number=Sing|Gender=Fem|Person=3|Poss=Yes|PronType=Prs 
her	PRON	Case=Acc|Gender=Fem|Number=Sing|Person=3|PronType=Prs 
herbalist	NOUN	_
here	ADV	PronType=Dem 
Herod	PROPN	_
he's	PRON	_
hey	INTJ	_
high	VERB	_
high	ADJ	_
high	NOUN	_
high-	X	_
highest	NOUN	_
highest	ADJ	_
highwa-	X	_
highway	NOUN	_
hihi	INTJ	_
hii	INTJ	_
Hilux	PROPN	_
him	PRON	Case=Nom|Gender=Masc|Number=Sing|Person=3|PronType=Prs 
him	PRON	Case=Acc|Gender=Masc|Number=Sing|Person=3|PronType=Prs 
himself	PRON	Number=Sing|Gender=Masc|Person=3|PronType=Prs 
hip	NOUN	_
hip-	NOUN	_
his	ADJ	Gender=Masc|Number=Sing|Person=3|Poss=Yes|PronType=Prs 
hit	VERB	_
hm	INTJ	_
hmhm	INTJ	_
hnhn	INTJ	_
ho	X	_
ho-	X	_
hold	VERB	_
home	NOUN	_
Honeywell	PROPN	_
hook	VERB	_
hope	VERB	_
hope	NOUN	_
hopsital	NOUN	_
hosanna	INTJ	_
hospital	NOUN	_
hostel	NOUN	_
hot	ADJ	_
hours	NOUN	Number=Plur 
house	NOUN	_
househood	NOUN	_
houses	NOUN	Number=Plur 
how	ADV	PronType=Int 
HR	PROPN	_
Hull	PROPN	_
huma-	NOUN	_
human	ADJ	_
human	NOUN	_
humhum	INTJ	_
hundred	NUM	NumType=Card 
hundredi	NOUN	NumType=Card 
hunger	NOUN	_
hungry	ADJ	_
hunter	NOUN	_
hurry	VERB	_
hus-	NOUN	_
husband	NOUN	_
hustle	NOUN	_
hustle	VERB	_
hustling	VERB	Tense=Pres|VerbForm=Part
I	PRON	Case=Nom|Number=Sing|Person=1|PronType=Prs
i-	X	_
i-	NOUN	_
Ibadan	PROPN	_
Ibeji	PROPN	_
idea	NOUN	_
Idimudo	PROPN	_
idle	ADJ	_
if	SCONJ	_
igb]	PUNCT	_
Ikpoba	PROPN	_
im	PRON	Case=Nom|Number=Sing|Person=3|PronType=Prs 
im	ADJ	Number=Sing|Person=3|Poss=Yes|PronType=Prs 
im-	X	_
I'm	VERB	_
imagine	VERB	_
imbecile	NOUN	_
immediate	ADJ	_
immediately	ADV	_
Immigration	PROPN	_
immunisation	NOUN	_
immunise	VERB	_
immunize	VERB	_
Imoh	PROPN	_
Imonirhua	PROPN	_
impact	NOUN	_
impatience	NOUN	_
import	VERB	_
important	ADJ	_
impossible	ADJ	_
improve	VERB	_
imsef	PRON	Case=Acc|Number=Sing|Person=3|PronType=Prs|Reflex=Yes
in	ADP	_
in	X	_
in-	X	_
incident	NOUN	_
including	ADP	_
increase	INTJ	_
increase	VERB	_
indigene	NOUN	_
indiscipline	NOUN	_
Indomie	PROPN	_
indomie	NOUN	_
infact	ADV	_
inferior	ADJ	_
Infinity	PROPN	_
influence	VERB	_
Info	PROPN	_
information	NOUN	_
infrastructure	NOUN	_
ingredient	NOUN	_
ingredients	NOUN	Number=Plur 
injection	NOUN	_
injury	NOUN	_
inlaw	NOUN	_
innovation	NOUN	_
insi-	X	_
inside	ADP	_
insist	VERB	_
insists	VERB	Mood=Ind|Number=Sing|Person=3|Tense=Pres|VerbFor=Fin 
Instagram	PROPN	_
instead	ADV	_
intending	VERB	_
interest	NOUN	_
interested	ADJ	_
interesting	ADJ	_
internationally	ADV	_
Internet	PROPN	_
internet	NOUN	_
interview	VERB	_
into	ADP	_
invite	VERB	_
Ipad	NOUN	_
IPO	PROPN	_
Irrua	PROPN	_
is	VERB	PartType=Cop 
is	AUX	Mood=Ind|Number=Sing|Person=3|Tense=Pres|VerbFor=Fin 
is	AUX	Mood=Ind 
Iscariot	PROPN	_
issue	NOUN	_
issues	NOUN	_
it	PRON	Case=Acc|Number=Sing|Person=3|PronType=Prs 
itching	VERB	_
its	PART	_
it's	X	_
Iya	PROPN	_
Iyabo	PROPN	_
j-	X	_
jam	VERB	_
JAMB	PROPN	_
jamb	NOUN	_
James	PROPN	_
January	PROPN	_
jara	NOUN	_
jare	ADV	_
Jatto	PROPN	_
jazz	NOUN	_
jealous	ADJ	_
jeans	NOUN	Number=Plur
jel	VERB	_
jerrycan	NOUN	_
jest	VERB	_
Jesus	PROPN	_
Jettan	PROPN	_
job	NOUN	_
jobman	NOUN	_
jobs	NOUN	Number=Plur 
John	PROPN	_
join	VERB	_
joint	NOUN	_
joke	NOUN	_
Jonathan	PROPN	_
Jos	PROPN	_
Joseph	PROPN	_
journalism	NOUN	_
journalist	NOUN	_
journey	NOUN	_
Joy	PROPN	_
JSS	PROPN	_
ju	X	_
Judas	PROPN	_
Judea	PROPN	_
jum-	X	_
jump	VERB	_
jumpy	ADJ	_
Junction	PROPN	_
junction	NOUN	_
junior	ADJ	_
just	ADV	_
k-	NOUN	_
kai	INTJ	_
kain	NOUN	_
kain	ADJ	_
Kan	X	_
kanda	NOUN	_
Kano	PROPN	_
ƙari	NOUN	_
Karo	PROPN	_
kashi	NOUN	_
Katako	PROPN	_
keep	NOUN	_
keep	VERB	_
kernel	NOUN	_
kerosine	NOUN	_
kick	VERB	_
kidnap	VERB	_
kids	NOUN	Number=Plur 
kill	VERB	_
kind	NOUN	_
kind	ADJ	_
kindgom	NOUN	_
kinds	NOUN	Number=Plur
king	NOUN	_
kingdom	NOUN	_
kings	NOUN	Number=Plur
Kini	X	_
kitchen	NOUN	_
kneel	VERB	_
knife	NOUN	_
knock	VERB	_
know	VERB	_
ko	INTJ	_
koko	NOUN	_
Kokokori	PROPN	_
kpai	INTJ	_
kpai	VERB	_
kpalasa	ADJ	_
Kpangolo	PROPN	_
kpusha	NOUN	_
kuka	NOUN	_
kuku	VERB	_
kuku	ADV	_
kukuma	ADV	_
kuma	PART	_
kunu	NOUN	_
kwa	X	_
l-	X	_
la-	X	_
lab	NOUN	_
label	NOUN	_
labourer	NOUN	_
lack	VERB	_
lady	NOUN	_
lae	INTJ	_
Lagos	PROPN	_
lailai	ADV	_
land	NOUN	_
language	NOUN	_
laptop	NOUN	_
last	ADJ	_
late	ADJ	_
later	ADV	Degree=Cmp 
laugh	VERB	_
laugh	NOUN	_
Lawrence	PROPN	_
lawyer	NOUN	_
le-	XX	_
lead	VERB	_
leader	NOUN	_
leaders	NOUN	Number=Plur
leaf	NOUN	_
League	PROPN	_
lean	ADJ	_
learn	VERB	_
learning	NOUN	_
least	ADV	_
leave	NOUN	_
leave	VERB	_
leaves	NOUN	Number=Plur
leaving	VERB	_
lecture	NOUN	_
lecture	VERB	_
lecturer	NOUN	_
lectures	NOUN	Number=Plur 
lecturing	NOUN	_
left	VERB	Mood=Ind|Tense=Past|VerbForm=Fin 
left	NOUN	_
leg	NOUN	_
less	ADJ	Degree=Cmp 
lesson	NOUN	_
let	VERB	_
let's	AUX	_
letter	NOUN	_
level	NOUN	_
liability	NOUN	_
library	NOUN	_
license	NOUN	_
license	VERB	_
lie	VERB	_
life	NOUN	_
Lifo	PROPN	_
light	NOUN	_
like	ADP	_
like	VERB	_
likeness	NOUN	_
line	NOUN	_
links	NOUN	Number=Plur 
lipstick	NOUN	_
listen	VERB	_
little	ADJ	_
live	VERB	_
Liverpool	PROPN	_
load	NOUN	_
load	VERB	_
local	ADJ	_
locate	VERB	_
lock	VERB	_
London	PROPN	_
long	ADJ	_
longer	ADJ	Degree=Cmp 
look	VERB	_
lose	VERB	_
lot	NOUN	_
loud	ADJ	_
Love	PROPN	_
love	NOUN	_
love	VERB	_
loving	VERB	Tense=Pres|VerbForm=Part 
low	ADJ	_
loyal	ADJ	_
luc-	X	_
Luke	PROPN	_
lunch	NOUN	_
m	X	_
m-	X	_
ma	PRON	Number=Sing|Person=1|Poss=Yes|PronType=Prs 
Ma	NOUN	_
ma	PART	_
ma-	X	_
Ma-	PROPN	_
maale	NOUN	_
machine	NOUN	_
mad	ADJ	_
Madam	NOUN	_
madam	NOUN	_
maggi	NOUN	_
mah	AUX	Mood=Jus 
Maharaji	PROPN	_
mai	PART	_
maigadi	NOUN	_
main	ADJ	_
maintain	VERB	_
maize	NOUN	_
major	ADJ	_
make	AUX	Mood=Jus 
make	VERB	_
makeup	NOUN	_
making	VERB	Tense=Pres|VerbForm=Part 
male	NOUN	_
malta	NOUN	_
Mama	PROPN	_
mama	NOUN	_
Man	PROPN	_
man	NOUN	_
mana	ADV	_
mana-	X	_
manage	VERB	_
manager	NOUN	_
manger	NOUN	_
Mangu	PROPN	_
many	ADJ	_
market	NOUN	_
Market	PROPN	_
marriage	NOUN	_
marriages	NOUN	Number=Plur 
married	ADJ	_
marry	VERB	_
Mary	PROPN	_
masa	NOUN	_
Mass	PROPN	_
masses	NOUN	Number=Plur 
master	NOUN	_
masters	NOUN	Number=Plur 
mata	NOUN	_
mate	NOUN	_
material	NOUN	_
material	ADJ	_
maternity	NOUN	_
Mathematics	PROPN	_
mathematics	NOUN	_
Mathias	PROPN	_
matter	NOUN	_
matters	NOUN	Number=Plur 
Matthew	PROPN	_
mature	ADJ	_
Max-	PROPN	_
Maxwell	PROPN	_
maybe	ADV	_
Mbafo	PROPN	_
Mbrama	PROPN	_
me	PRON	Case=Nom|Number=Sing|Person=1|PronType=Prs 
me	PRON	Case=Acc|Number=Sing|Person=1|PronType=Prs 
me-	X	_
meal	NOUN	_
mean	VERB	_
means	NOUN	Number=Plur 
means	VERB	Mood=Ind|Number=Sing|Person=3|Tense=Pres|VerbFor=Fin 
meanwhile	ADV	_
measure	VERB	_
meat	NOUN	_
mechanic	NOUN	_
media	NOUN	_
medical	ADJ	_
medication	NOUN	_
medicinal	ADJ	_
medicine	NOUN	_
medin	NOUN	_
medium	ADJ	_
meet	VERB	_
meh	AUX	Mood=Jus 
mehn	INTJ	_
member	NOUN	_
members	NOUN	Number=Plur 
men	NOUN	Number=Plur 
mend	VERB	_
menial	ADJ	_
mentality	NOUN	_
mentioning	VERB	Tense=Pres|VerbForm=Part 
merry	ADJ	_
message	NOUN	_
messages	NOUN	Number=Plur 
method	NOUN	_
mey	AUX	Mood=Jus 
mhm	INTJ	_
Middle	PROPN	_
middle	NOUN	_
mighty	ADJ	_
mil-	ADJ	_
military	NOUN	_
milk	NOUN	_
mille	NOUN	_
million	NUM	NumType=Card 
millionaire	NOUN	_
Milo	PROPN	_
mind	NOUN	_
mineral	NOUN	_
minerals	NOUN	Number=Plur
mingwo	NOUN	_
Mini-me	PROPN	_
minister	VERB	_
minus	CCONJ	_
minute	NOUN	_
minutes	NOUN	Number=Plur 
miracle	NOUN	_
misbehave	VERB	_
miserable	ADJ	_
mislead	VERB	_
Miss	PROPN	_
miss	VERB	_
mistake	NOUN	_
mistress	NOUN	_
miyan	NOUN	_
mo	X	_
mo-	X	_
moder	NOUN	_
moders	NOUN	Number=Plur 
moh	AUX	_
moinmoin	NOUN	_
moko	VERB	_
moment	NOUN	_
Mon-	PROPN	_
mon-	NOUN	_
Monday	PROPN	_
money	NOUN	_
monkey	NOUN	_
month	NOUN	_
months	NOUN	Number=Plur 
moral	ADJ	_
more	ADV	_
more	ADJ	_
morning	NOUN	_
mortar	NOUN	_
mosque	NOUN	_
most	ADJ	_
mostly	ADV	_
mother	NOUN	_
motherhood	NOUN	_
mothers	NOUN	Number=Plur 
moto	NOUN	_
motor	NOUN	_
motors	NOUN	Number=Plur 
mountain	NOUN	_
mouth	NOUN	_
move	VERB	_
mstchew	INTJ	_
mtchew	INTJ	_
mtschew	INTJ	_
mtshew	INTJ	_
mu-	X	_
much	ADV	_
much	ADJ	_
Mummy	PROPN	_
mummy	NOUN	_
mumsy	NOUN	_
Munich	PROPN	_
museum	NOUN	_
must	AUX	VerbForm=Fin 
my	ADJ	Number=Sing|Person=1|Poss=Yes|PronType=Prs 
mysef	PRON	Case=Acc|Number=Sing|Person=1|PronType=Prs|Reflex=Yes 
myself	PRON	Case=Acc|Number=Sing|Person=1|PronType=Prs|Reflex=Yes 
n-	X	_
na	PART	PartType=Cop 
Naija	PROPN	_
naija	NOUN	_
naim	ADV	_
naira	X	_
naira	NOUN	_
naked	ADJ	_
name	NOUN	_
names	NOUN	Number=Plur 
narrate	VERB	_
NASCO	PROPN	_
Nasco	PROPN	_
National	PROPN	_
national	ADJ	_
native	ADJ	_
natural	ADJ	_
ND	PROPN	_
ne	X	_
near	ADJ	_
nearer	ADJ	Degree=Cmp 
NECO	PROPN	_
need	VERB	_
needle	NOUN	_
neighbour	NOUN	_
neighbours	NOUN	Number=Plur 
net	NOUN	_
never	AUX	Aspect=Perf|Polarity=Neg 
New	PROPN	_
new	ADJ	_
newly	ADV	_
news	NOUN	_
next	ADJ	_
Ngas	PROPN	_
NGO	NOUN	_
ni	X	_
nice	NOUN	_
Nige-	X	_
Nigeria	PROPN	_
Nigerian	ADJ	_
Nigerian	NOUN	_
Nigerian	PROPN	_
Nigerians	PROPN	Number=Plur
night	NOUN	_
nine	NUM	_
nineteenth	NOUN	NumType=Ord 
ninety	NUM	NumType=Card 
ninety	NUM	_
Nkechi	PROPN	_
nko	INTJ	_
nna	X	_
no	INTJ	Polarity=Neg 
no	PART	Polarity=Neg 
nobody	PRON	_
noise	NOUN	_
none	NOUN	_
nonsense	NOUN	_
norm-	X	_
normal	ADJ	_
normally	ADV	_
north	ADV	_
north	NOUN	_
not	PART	Polarity=Neg 
nothing	PRON	_
notice	VERB	_
notice	NOUN	_
notin	PRON	_
noting	PRON	_
November	PROPN	_
now	ADV	_
nowadays	ADV	_
ntughari	X	_
number	NOUN	_
Nursery	PROPN	_
nursery	NOUN	_
nut	NOUN	_
nutritional	ADJ	_
nutritious	ADJ	_
NYSC	PROPN	_
o	PART	PartType=Disc 
Obama	PROPN	_
observe	VERB	_
occupied	VERB	Tense=Past|VerbForm=Part|Voice=Pass
o'clock	ADV	_
October	PROPN	_
oda	ADJ	_
oder	ADJ	_
oder	NOUN	_
oders	NOUN	Number=Plur 
Oduduwa	PROPN	_
of	ADP	_
offend	VERB	_
office	NOUN	_
offload	X	_
Oga	PROPN	_
oga	NOUN	_
Ogo	PROPN	_
Ogui	PROPN	_
oh	INTJ	_
oh	X	_
oho	INTJ	_
oil	NOUN	_
ojuju	NOUN	_
okadas	NOUN	Number=Plur 
okay	INTJ	_
Oke	PROPN	_
Okemute	PROPN	_
Okirika	PROPN	_
Okitipupa	PROPN	_
Okpolo	PROPN	_
okrika	NOUN	_
okririka	NOUN	_
Okulolo	PROPN	_
old	ADJ	_
older	ADJ	Degree=Cmp 
Oluchi	PROPN	_
omo	NOUN	_
on	ADP	_
once	SCONJ	_
once	ADV	_
Ondo	PROPN	_
one	DET	Definite=Spec|Number=Sing|PronType=Art 
one	NOUN	_
one	NUM	NumType=Card 
ones	NOUN	Number=Plur 
onions	NOUN	Number=Plur 
Onitsha	PROPN	_
onl-	ADV	_
only	ADJ	_
only	ADV	_
o'oh	INTJ	_
Open	PROPN	_
open	VERB	_
Open-	PROPN	_
operate	VERB	_
operation	NOUN	_
opinion	NOUN	_
OPM	PROPN	_
opportunities	NOUN	Number=Plur 
opportunity	NOUN	_
oppress	VERB	_
oppression	NOUN	_
or	CCONJ	_
ordinary	ADJ	_
Ori-	X	_
ori-	X	_
Oriental	PROPN	_
origi-	NOUN	_
original	ADJ	_
Oshodi	PROPN	_
other	ADJ	_
our	ADJ	Number=Plur|Person=1|Poss=Yes|PronType=Prs 
oursef	PRON	Case=Acc|Number=Plur|Person=1|PronType=Prs[Reflex=Yes 
oursefs	PRON	Case=Acc|Number=Plur|Person=1|PronType=Prs[Reflex=Yes 
ourself	PRON	Case=Acc|Number=Plur|Person=1|PronType=Prs[Reflex=Yes 
ourselves	PRON	Case=Acc|Number=Plur|Person=1|PronType=Prs[Reflex=Yes 
out	ADP	_
outside	ADP	_
over	ADP	_
overcome	VERB	_
overtay	VERB	_
owe	VERB	_
own	ADJ	_
Oxford	PROPN	_
oya	PART	_
Oyinbo	PROPN	_
Oyinbo	ADJ	_
pa	NOUN	_
pace	NOUN	_
pack	VERB	_
package	NOUN	_
pain	VERB	_
paint	VERB	_
Palace	PROPN	_
palace	NOUN	_
palaver	NOUN	_
pan	NOUN	_
pap	NOUN	_
papa	NOUN	_
paper	NOUN	_
papers	NOUN	Number=Plur 
parade	NOUN	_
parent	NOUN	_
parents	NOUN	Number=Plur 
park	VERB	_
park	NOUN	_
part	NOUN	_
parts	NOUN	Number=Plur
party	NOUN	_
pass	ADP	_
pass	VERB	_
passionate	ADJ	_
past	ADJ	_
pastor	NOUN	_
patch	NOUN	_
patch	VERB	_
patience	NOUN	_
patient	NOUN	_
patients	NOUN	Number=Plur
pay	VERB	_
pe-	X	_
peace	NOUN	_
peaceful	ADJ	_
pedal	VERB	_
pedaling	VERB	Tense=Pres|VerbForm=Part 
pencil	NOUN	_
Penny	PROPN	_
pension	NOUN	_
pensioner	NOUN	_
people	NOUN	_
pepper	NOUN	_
Pepper	PROPN	_
per	ADP	_
perfect	ADJ	_
perfume	NOUN	_
period	NOUN	_
pers-	NOUN	_
person	NOUN	_
personal	ADJ	_
personally	ADV	_
pertaining	VERB	Tense=Pres|VerbForm=Part 
Peter	PROPN	_
PhD	NOUN	_
Philip	PROPN	_
phone	NOUN	_
phone	VERB	_
phonetics	NOUN	_
photo	NOUN	_
physical	ADJ	_
pi	X	_
pick	VERB	_
picture	NOUN	_
Pidgin	ADJ	_
Pidgin	PROPN	_
piece	NOUN	_
pieces	VERB	_
pig	NOUN	_
pikin	NOUN	_
pinch	VERB	_
pipeline	NOUN	_
pity	VERB	_
pl-	X	_
place	NOUN	_
places	NOUN	Number=Plur 
plain	ADJ	_
plait	VERB	_
plan	NOUN	_
plan	VERB	_
plate	NOUN	_
Plateau	PROPN	_
play	VERB	_
player	NOUN	_
players	NOUN	Number=Plur 
please	VERB	_
please	INTJ	_
plenty	ADJ	_
plus	ADJ	_
plus	CCONJ	_
pocket	NOUN	_
point	NOUN	_
point	VERB	_
poison	NOUN	_
Police	PROPN	_
police	NOUN	_
policeman	NOUN	_
polio	NOUN	_
politicians	NOUN	Number=Plur 
poly	NOUN	_
ponmo	NOUN	_
poor	ADJ	_
popsy	NOUN	_
porridge	NOUN	_
Port	PROPN	_
pose	VERB	_
position	NOUN	_
positive	ADJ	_
possessive	ADJ	_
possible	ADJ	_
post	VERB	_
pot	NOUN	_
potash	NOUN	_
pound	VERB	_
pounded	ADJ	_
pour	VERB	_
powder	NOUN	_
power	NOUN	_
powerful	ADJ	_
pray	VERB	_
prayer	NOUN	_
praying	VERB	Tense=Pres|VerbForm=Part 
preach	VERB	_
predators	NOUN	Number=Plur
pre-degree	NOUN	_
pregnant	VERB	_
pregnant	ADJ	_
Premier	PROPN	_
prep	NOUN	_
prepare	VERB	_
present	ADJ	_
presenter	NOUN	_
president	NOUN	_
press	VERB	_
pretend	VERB	_
pretime	ADJ	_
price	VERB	_
price	NOUN	_
Primary	PROPN	_
primary	NOUN	_
primary	ADJ	_
private	ADJ	_
pro-	X	_
probability	NOUN	_
problem	NOUN	_
process	VERB	_
profession	NOUN	_
professors	NOUN	Number=Plur 
programme	NOUN	_
programmes	NOUN	Number=Plur 
progress	VERB	_
promise	VERB	_
promises	NOUN	Number=Plur 
promotion	NOUN	_
proofs	NOUN	Number=Plur 
protect	VERB	_
protein	NOUN	_
proteinaceous	ADJ	_
provided	VERB	Mood=Ind|Tense=Past|VerbForm=Fin 
provision	NOUN	_
provoke	VERB	_
pu	X	_
publi-	X	_
public	ADJ	_
pudding	NOUN	_
pull	VERB	_
pumpkin	NOUN	_
punish	VERB	_
pur-	NOUN	_
pure	ADJ	_
pursue	VERB	_
push	VERB	_
put	VERB	_
quarrel	NOUN	_
quarrel	VERB	_
quarter	NOUN	_
queen	NOUN	_
Queen	PROPN	_
queens	NOUN	Number=Plur
question	NOUN	_
queue	NOUN	_
quick	ADJ	_
quickly	ADV	_
quiet	ADJ	_
r-	VERB	_
rader	ADV	_
radio	NOUN	_
rain	NOUN	_
rank	NOUN	_
rate	VERB	_
re-	XX	_
reach	VERB	_
read	VERB	_
reading	NOUN	_
ready	ADJ	_
real	ADJ	_
reality	NOUN	_
really	ADV	_
reason	VERB	_
reasons	NOUN	Number=Plur
receipt	NOUN	_
receive	VERB	_
recent	ADJ	_
recently	ADV	_
reception	NOUN	_
recession	NOUN	_
recommended	VERB	Mood=Ind|Tense=Past|VerbForm=Fin 
record	VERB	_
recover	VERB	_
red	ADJ	_
reduce	NOUN	_
reduce	VERB	_
refer	VERB	_
refil	NOUN	_
refill	VERB	_
refill	NOUN	_
refine	VERB	_
refinery	NOUN	_
region	NOUN	_
register	NOUN	_
register	VERB	_
registration	NOUN	_
regularly	ADV	_
reject	VERB	_
relationship	NOUN	_
relax	VERB	_
religion	NOUN	_
religious	ADJ	_
remain	ADJ	_
remain	VERB	_
remaining	ADJ	_
remember	VERB	_
remind	VERB	_
remove	VERB	_
renovation	NOUN	_
rent	VERB	_
rent	NOUN	_
repent	VERB	_
reply	NOUN	_
report	VERB	_
res-	X	_
research	VERB	_
respect	VERB	_
response	NOUN	_
rest	VERB	_
rest	NOUN	_
result	NOUN	_
resume	VERB	_
return	VERB	_
revenue	NOUN	_
reverse	VERB	_
revive	VERB	_
revolution	NOUN	_
rewrite	VERB	_
rice	NOUN	_
rich	ADJ	_
right	NOUN	_
right	ADV	_
rinse	VERB	_
ritual	NOUN	_
river	NOUN	_
River	PROPN	_
Road	PROPN	_
road	NOUN	_
rob	VERB	_
robber	NOUN	_
Roman	ADJ	_
romantic	ADJ	_
Rome	PROPN	_
roof	NOUN	_
room	NOUN	_
rotten	ADJ	_
rough	VERB	_
round	ADP	_
round	VERB	_
rubber	NOUN	_
rubbish	NOUN	_
rule	VERB	_
Rumuokuta	PROPN	_
run	NOUN	_
run	VERB	_
rush	VERB	_
ruwa	NOUN	_
s-	VERB	_
s-	X	_
sabi	VERB	_
sack	VERB	_
sacred	ADJ	_
sacrifice	NOUN	_
safe	ADJ	_
sake	NOUN	_
Sala	PROPN	_
salary	NOUN	_
Salawu	PROPN	_
salon	NOUN	_
salt	NOUN	_
salute	VERB	_
same	ADJ	_
sample	NOUN	_
Samson	PROPN	_
Sanch-	X	_
Sanchez	PROPN	_
sand	NOUN	_
sandal	NOUN	_
sandsand	NOUN	_
satisfy	VERB	_
save	VERB	_
saviour	NOUN	_
saw	VERB	Mood=Ind|Tense=Past|VerbForm=Fin 
say	VERB	_
sca-	VERB	_
scatter	VERB	_
School	PROPN	_
school	VERB	_
school	PART	_
school	NOUN	_
schools	NOUN	Number=Plur 
science	NOUN	_
sciences	NOUN	Number=Plur
score	VERB	_
Scout	PROPN	_
screen	VERB	_
screener	NOUN	_
se-	PART	_
se-	VERB	_
search	VERB	_
season	NOUN	_
second	ADJ	NumType=Ord 
secondary	ADJ	_
secret	NOUN	_
secretariat	NOUN	_
secretary	NOUN	_
secure	VERB	_
secure	ADJ	_
security	NOUN	_
see	VERB	_
seeing	VERB	Tense=Pres|VerbForm=Part 
sef	PART	PartType=Disc 
segment	NOUN	_
select	VERB	_
self	PART	PartType=Disc 
selfie	NOUN	_
sell	VERB	_
selling	VERB	Tense=Pres|VerbForm=Part 
semo	NOUN	_
send	VERB	_
senior	VERB	_
senior	ADJ	_
sense	NOUN	_
sense	VERB	_
series	NOUN	_
serious	ADJ	_
serve	VERB	_
service	NOUN	_
set	NOUN	_
set	VERB	_
setay	VERB	_
settle	VERB	_
seven	NUM	NumType=Card 
seventeen	NUM	NumType=Card 
seventy	NUM	NumType=Card 
sew	VERB	_
sewing	NOUN	_
sex	NOUN	_
sexes	NOUN	Number=Plur
sey	SCONJ	_
sha	PART	PartType=Disc 
shade	VERB	_
shaft	NOUN	_
shake	VERB	_
shaking	VERB	_
shame	VERB	_
shaperly	ADV	_
share	VERB	_
sharing	NOUN	_
sharp	VERB	_
sharp	ADJ	_
sharwama	NOUN	_
she	PRON	Case=Nom|Number=Sing|Person=3|PronType=Prs 
shebi	PART	PronType=Int 
shell	NOUN	_
shey	PART	PronType=Int 
shine	VERB	_
shirt	NOUN	_
sho	INTJ	_
shock	VERB	_
shoe	NOUN	_
shoo	INTJ	_
shool	NOUN	_
shoot	VERB	_
shop	NOUN	_
shop	VERB	_
shopping	VERB	Tense=Pres|VerbForm=Part 
shopping	NOUN	_
shops	NOUN	Number=Plur 
short	ADJ	_
shortcut	NOUN	_
should	AUX	VerbForm=Fin
shout	NOUN	_
shout	VERB	_
show	VERB	_
show	NOUN	_
shower	NOUN	_
shshsh	INTJ	_
shu-	X	_
shut	VERB	_
siblings	NOUN	Number=Plur 
sick	ADJ	_
sick	VERB	_
sickness	NOUN	_
siddon	VERB	_
siddown	VERB	_
side	NOUN	_
sidown	VERB	_
sign	VERB	_
sign	NOUN	_
signal	NOUN	_
silently	ADV	_
Simon	PROPN	_
sin	NOUN	_
since	ADP	_
sincere	ADJ	_
sing	VERB	_
sins	NOUN	Number=Plur 
Sir	PROPN	_
sis	NOUN	_
sister	NOUN	_
sisters	NOUN	Number=Plur 
sit	VERB	_
site	NOUN	_
situation	NOUN	_
six	NUM	NumType=Card 
sixteen	NUM	NumType=Card 
sixty	NUM	NumType=Card 
skin	NOUN	_
skirt	NOUN	_
slap	NOUN	_
slap	VERB	_
sleep	VERB	_
sleep	NOUN	_
slice	NOUN	_
slice	VERB	_
sliding	ADJ	_
sm-	X	_
small	ADJ	_
smell	VERB	_
smelling	VERB	Tense=Pres|VerbForm=Part 
smile	VERB	_
smoke	VERB	_
smooth	ADJ	_
smooth	VERB	_
smuggle	VERB	_
snakes	NOUN	Number=Plur
snap	VERB	_
so	SCONJ	_
so	ADV	_
so-	X	_
social	ADJ	_
society	NOUN	_
soft	ADJ	_
soldier	NOUN	_
soldiers	NOUN	Number=Plur 
solid	ADJ	_
solve	VERB	_
som-	X	_
some	DET	_
some	PRON	_
somebody	PRON	_
something	PRON	_
sometime	ADV	_
sometimes	ADV	_
sometin	PRON	_
someting	PRON	_
somewhere	ADV	_
son	NOUN	_
soon	ADV	_
sorry	ADJ	_
sotay	SCONJ	_
soup	NOUN	_
spare	ADJ	_
spare	VERB	_
speak	VERB	_
special	ADJ	_
specialist	NOUN	_
spend	VERB	_
spinach	NOUN	_
spoil	VERB	_
spoken	VERB	Tense=Past|VerbForm=Part 
sponsors	NOUN	Number=Plur 
spread	VERB	_
Square	PROPN	_
square	NOUN	_
squeeze	VERB	_
SS	PROPN	_
SSCE	PROPN	_
st	X	_
stadium	NOUN	_
staff	NOUN	_
stagger	VERB	_
stand	VERB	_
star	NOUN	_
starch	NOUN	_
start	VERB	_
started	VERB	Mood=Ind|Tense=Past|VerbForm=Fin 
starve	VERB	_
State	PROPN	_
state	NOUN	_
Station	PROPN	_
station	NOUN	_
statistics	NOUN	_
stay	VERB	_
staying	VERB	Tense=Pres|VerbForm=Part 
steady	ADJ	_
step	VERB	_
step	NOUN	_
still	ADV	_
still	ADJ	_
stir	VERB	_
stitching	NOUN	_
sto-	X	_
stone	NOUN	_
stones	NOUN	Number=Plur
stop	VERB	_
stories	NOUN	Number=Plur 
story	NOUN	_
stove	NOUN	_
straight	ADJ	_
street	NOUN	_
stress	VERB	_
stressful	ADJ	_
strike	NOUN	_
strong	ADJ	_
struggle	VERB	_
stubborn	ADJ	_
student	NOUN	_
students	ADV	Number=Plur 
studio	NOUN	_
study	NOUN	_
stuff	NOUN	_
stupid	ADJ	_
style	NOUN	_
Su-	X	_
su-	X	_
subjects	NOUN	Number=Plur
succeed	VERB	_
successful	ADJ	_
suffer	VERB	_
suffering	NOUN	_
sugar	NOUN	_
suit	NOUN	_
Sunday	PROPN	_
Sundays	PROPN	Number=Plur
super	ADJ	_
superior	ADJ	_
supermarket	NOUN	_
supervise	VERB	_
support	VERB	_
suppose	VERB	Mood=Imp 
suppose	VERB	_
suprising	ADJ	_
sure	ADJ	_
surprise	VERB	_
survive	VERB	_
suya	NOUN	_
swagger	NOUN	_
swallow	NOUN	_
swallow	VERB	_
Swansea	PROPN	_
swe-	ADJ	_
swear	VERB	_
sweater	NOUN	_
sweet	ADJ	_
swim	VERB	_
swim	NOUN	_
swing	VERB	_
t	X	_
t-	X	_
t-	VERB	_
ta-	X	_
tah	INTJ	_
tail	NOUN	_
tailor	NOUN	_
take	VERB	_
talk	NOUN	_
talk	VERB	_
talking	VERB	Tense=Pres|VerbForm=Part 
tan-	X	_
tanda	VERB	_
tank	NOUN	_
tarara	X	_
taste	VERB	_
taste	NOUN	_
taushe	NOUN	_
taxi	NOUN	_
tay	VERB	_
teach	VERB	_
teacher	NOUN	_
teachers	NOUN	Number=Plur 
teaching	VERB	Tense=Pres|VerbForm=Part 
team	NOUN	_
technical	ADJ	_
technician	NOUN	_
technicians	NOUN	Number=Plur 
televi-	X	_
tell	VERB	_
telling	VERB	Tense=Pres|VerbForm=Part 
temptation	NOUN	_
ten	NUM	NumType=Card 
tenant	NOUN	_
terrible	_	_
terribly	ADV	_
test	VERB	_
testimony	NOUN	_
Texas	PROPN	_
Thaddeus	PROPN	_
than	ADP	_
thank	VERB	_
that	SCONJ	_
that's	PART	_
the	DET	Definite=Def|PronType=Art 
them	PRON	Case=Acc|Number=Plur|Person=3|PronType=Prs 
then	ADV	_
Theophilus	PROPN	_
there	PRON	PronType=Dem 
there	ADV	_
there's	PART	_
thick	ADJ	_
thicken	VERB	_
thief	VERB	_
thief	NOUN	_
thing	NOUN	_
things	NOUN	Number=Plur 
think	VERB	_
thinking	VERB	Tense=Pres|VerbForm=Part 
third	ADJ	Degree=Pos|NumType=Ord
thirteen	NUM	NumType=Card 
thirty	NUM	NumType=Card 
this	DET	Number=Sing|PronType=Dem 
Thomas	PROPN	_
those	DET	Number=Sing|PronType=Dem 
though	SCONJ	_
thousand	NUM	NumType=Card 
thread	NOUN	_
three	NUM	NumType=Card 
throat	NOUN	_
through	NOUN	_
throughout	ADP	_
throw	VERB	_
ti-	VERB	_
ticket	NOUN	_
tie	NOUN	_
tief	VERB	_
tiger	NOUN	_
till	ADP	_
time	NOUN	_
times	NOUN	Number=Plur
timetable	NOUN	_
tin	PRON	_
tin	X	_
tin	NOUN	_
ting	NOUN	_
tings	X	Number=Plur 
tings	NUM	Number=Plur 
tings	NOUN	Number=Plur 
tink	VERB	_
tinrinrin	X	_
tins	NOUN	Number=Plur 
tiny	ADJ	_
tire	VERB	_
tired	ADJ	_
Titi	PROPN	_
title	NOUN	_
to	ADP	_
toast	VERB	_
today	NOUN	_
togeda	ADV	_
togeder	ADV	_
together	ADV	_
toh	INTJ	_
toh	X	_
tomatoes	NOUN	Number=Plur
tomorrow	NOUN	_
too	ADV	_
tool	NOUN	_
tools	NOUN	Number=Plur 
top	ADJ	_
top	NOUN	_
topic	NOUN	_
torch	NOUN	_
torment	VERB	_
tory	NOUN	_
touch	VERB	_
tourist	NOUN	_
town	NOUN	_
tra-	X	_
traffi-	X	_
traffic	VERB	_
traffic	NOUN	_
trafficking	NOUN	_
trailer	NOUN	_
train	VERB	_
training	NOUN	_
transport	NOUN	_
transportation	NOUN	_
travel	NOUN	_
travel	VERB	_
treat	VERB	_
trek	VERB	_
trend	NOUN	_
tribe	NOUN	_
tribes	NOUN	Number=Plur
trophy	NOUN	_
trouble	NOUN	_
trough	ADP	_
trouser	NOUN	_
troway	VERB	_
trucks	NOUN	Number=Plur 
true	ADJ	_
trust	NOUN	_
trust	VERB	_
truth	NOUN	_
try	VERB	_
tsk	X	_
turn	VERB	_
turn	NOUN	_
TV	NOUN	_
twelve	NUM	NumType=Card 
twenty	NUM	NumType=Card 
twice	ADV	_
twin	NOUN	_
twins	NOUN	Number=Plur 
twist	VERB	_
two	NUM	NumType=Card 
type	NOUN	_
types	NOUN	Number=Plur
UBTH	PROPN	_
uhm	INTJ	_
uhn	INTJ	_
una	ADJ	Number=Plur|Person=2|Poss=Yes|PronType=Prs 
una	PRON	Case=Nom|Number=Plur|Person=2|PronType=Prs 
una	PRON	Case=Acc|Number=Plur|Person=2|PronType=Prs 
un-African	ADJ	_
unasef	PRON	Number=Plur|Person=2|PronType=Prs|Reflex=Yes 
uncle	NOUN	_
under	ADP	_
underground	ADV	_
understand	VERB	_
unexpected	ADJ	_
uniform	NOUN	_
Union	PROPN	_
unite	VERB	_
unity	NOUN	_
universities	NOUN	Number=Plur 
University	PROPN	_
university	NOUN	_
unless	SCONJ	_
until	ADP	_
unto	ADP	_
up	ADP	_
up-	X	_
upload	VERB	_
upon	ADP	_
upside	NOUN	_
Urhobo	PROPN	_
Uromi	PROPN	_
us	PRON	Case=Acc|Number=Plur|Person=1|PronType=Prs 
use	VERB	_
used	VERB	Mood=Ind|Tense=Past|VerbForm=Fin 
useful	ADJ	_
using	VERB	Tense=Pres|VerbForm=Part 
usual	ADJ	_
usually	ADV	_
utter	VERB	_
Uyere	X	_
value	VERB	_
ve-	X	_
vegetable	NOUN	_
very	ADV	_
vex	VERB	_
vex	NOUN	_
video	NOUN	_
view	VERB	_
vigilante	NOUN	_
village	NOUN	_
villages	NOUN	Number=Plur
vinegar	NOUN	_
violence	NOUN	_
VIP	NOUN	_
visit	VERB	_
visiting	ADJ	_
visitor	NOUN	_
vitamins	NOUN	Number=Plur
voice	NOUN	_
vomit	VERB	_
vote	NOUN	_
vote	VERB	_
vrendo	INTJ	_
w-	X	_
wa	INTJ	_
wa-	X	_
WAEC	PROPN	_
wah	SCONJ	_
wahala	NOUN	_
wai	PART	PartType=Disc 
wait	VERB	_
waka	VERB	_
wake	VERB	_
wallahi	INTJ	_
wan	VERB	_
want	VERB	_
wanted	VERB	Mood=Ind|Tense=Past|VerbForm=Fin 
wantintin	ADJ	_
ward	NOUN	_
warn	VERB	_
Warri	PROPN	_
was	AUX	AUX  Mood=Ind|Number=Sing|Pers=3|Tense=Past|VerbForm=Fin 
wash	VERB	_
Washington	PROPN	_
waste	VERB	_
waste	NOUN	_
wasting	VERB	Tense=Pres|VerbForm=Part 
watch	NOUN	_
watch	VERB	_
water	NOUN	_
watery	ADJ	_
way	NOUN	_
waya	VERB	_
waye	ADJ	_
ways	NOUN	Number=Plur
wazobia	NOUN	_
Wazobia	PROPN	_
we	PRON	Case=Nom|Number=Plur|Person=1|PronType=Prs 
wear	VERB	_
weather	NOUN	_
weda	SCONJ	_
wedding	NOUN	_
weder	SCONJ	_
Wednesday	PROPN	_
week	NOUN	_
weeks	NOUN	Number=Plur 
ween	INTJ	_
weh	SCONJ	_
weight	NOUN	_
well	ADV	_
well	NOUN	_
wella	ADV	_
wen	SCONJ	_
Wenger	PROPN	_
went	VERB	Mood=Ind|Tense=Past|VerbForm=Fin 
wesef	PRON	Number=Plur|Pers=1|PronType=Prs|Reflex=Yes 
West	PROPN	_
wet	X	_
wet-	PRON	_
wetin	PRON	PronType=Int 
we've	PRON	_
wey	SCONJ	_
what	PRON	PronType=Int 
what's	PART	_
wheda	SCONJ	_
wheder	CCONJ	_
when	ADV	PronType=Int 
where	ADV	PronType=Int 
whether	SCONJ	_
which	DET	PronType=Int 
while	SCONJ	_
white	ADJ	_
who	PRON	PronType=Int 
whole	ADJ	_
why	ADV	PronType=Int 
wid	ADP	_
wife	NOUN	_
wildlife	NOUN	_
will	AUX	_
win	VERB	_
wind	VERB	_
wind	NOUN	_
window	NOUN	_
windows	NOUN	Number=Plur 
wipe	VERB	_
wish	VERB	_
wit	ADP	_
witch	NOUN	_
with	ADP	_
withdraw	VERB	_
without	ADP	_
withstand	VERB	_
witness	VERB	_
witnesses	NOUN	Number=Plur 
witout	ADP	_
wives	NOUN	Number=Plur
wo-	X	_
woman	NOUN	_
women	NOUN	Number=Plur
wonder	NOUN	_
wonder	VERB	_
wonderful	ADJ	_
wood	NOUN	_
word	NOUN	_
work	VERB	_
work	NOUN	_
worker	NOUN	_
workers	NOUN	Number=Plur
workshop	NOUN	_
world	NOUN	_
worry	VERB	_
worse	VERB	_
worst	ADJ	Degree=Sup 
would	AUX	_
write	VERB	_
wrong	ADJ	_
X	X	_
X	VERB	_
X	PROPN	_
yakuwa	NOUN	_
yalo	NOUN	_
yam	NOUN	_
yard	NOUN	_
yarn	VERB	_
yarn	NOUN	_
yeah	INTJ	_
year	NOUN	_
years	NOUN	Number=Plur
yes	INTJ	_
yesterday	NOUN	_
yeye	ADJ	_
yi	VERB	_
yonda	ADV	_
yonder	ADV	_
Yor	X	_
yor]	PUNCT	_
York	PROPN	_
you	PRON	Case=Nom|Number=Sing|Person=2|PronType=Prs 
you	PRON	Case=Acc|Number=Sing|Person=2|PronType=Prs 
you'll	PART	_
young	ADJ	_
younger	ADJ	Degree=Cmp 
youngest	ADJ	Degree=Sup 
your	ADJ	Number=Sing|Person=2|Poss=Yes|PronType=Prs 
yours	PRON	_
yoursef	PRON	Person=2|PronType=Prs|Reflex=Yes 
yourself	PRON	Person=2|PronType=Prs|Reflex=Yes 
youself	PRON	Person=2|PronType=Prs|Reflex=Yes 
youth	NOUN	_
Zaks	PROPN	_
Zealot	PROPN	_
zonal	ADJ	_
zoo	NOUN	_
Zuba	PROPN	_
101	NOUN	_
419	NOUN	_
?//+	PUNCT	_
[[eng	VERB	_
[ara	PUNCT	_
A	NOUN	_
a-	X	_
a.m.	ADV	_
Abaki	PROPN	_
Abbey	PROPN	_
abf	X	_
Abia	PROPN	_
abinci	NOUN	_
able	ADJ	_
abound	VERB	_
abounds	VERB	Mood=Ind|Number=Sing|Person=3|Tense=Pres|VerbForm=Fin
Abubakar	PROPN	_
ac-	NOUN	_
academics	NOUN	_
acceptance	NOUN	_
accepted	ADJ	_
access	VERB	_
accident	NOUN	_
accommodate	VERB	_
accommodating	VERB	Tense=Pres|VerbForm=Part
accommodation	NOUN	_
accomplice	NOUN	_
account	NOUN	_
account	VERB	_
Accountability	PROPN	_
accountant	NOUN	_
accounting	NOUN	_
accusate	NOUN	_
accuse	VERB	_
acid	ADJ	_
acid	NOUN	_
across	ADP	_
ada	X	_
adaci	NOUN	_
adage	NOUN	_
Adamu	PROPN	_
address	VERB	_
Ade	PROPN	_
Adebayo	PROPN	_
Adeleye	PROPN	_
Adeniyi	PROPN	_
Adeshina	PROPN	_
Adesina	PROPN	_
Adewale	PROPN	_
Adeyinka	PROPN	_
adjourn	VERB	_
admin's	NOUN	_
Admiral	PROPN	_
Admissions	PROPN	_
admit	VERB	_
admitted	VERB	Tense=Past|VerbForm=Part
Adurogboye	PROPN	_
advocate	VERB	_
aeroplane	NOUN	_
Afenifere	PROPN	_
Affairs	PROPN	_
affect	VERB	_
afiaifere	NOUN	_
afihafereboh	NOUN	_
Afoda	PROPN	_
afojudi	NOUN	_
Africa	PROPN	_
Africa's	PROPN	_
Afuda	PROPN	_
against	ADP	_
agbada	NOUN	_
agbado	NOUN	_
Agbalagba	PROPN	_
agboro	NOUN	_
Agency	PROPN	_
agenda	NOUN	_
agent	NOUN	_
aggregate	NOUN	_
Aginnigbode	PROPN	_
agree	VERB	_
agric	ADJ	_
Agwan-	PROPN	_
ahm	INTJ	_
ahn	INTJ	_
Aido	PROPN	_
aifeeyanpeeyan	X	_
aifinipeni	X	_
Aijebe	PROPN	_
air	NOUN	_
Airforce	PROPN	_
airline	NOUN	_
airlines	NOUN	Number=Plur
airport	NOUN	_
airtime	NOUN	_
Aisha	PROPN	_
Ajayi	PROPN	_
ajebo	NOUN	_
Ajegunle	PROPN	_
Ajibike	PROPN	_
Aka	PROPN	_
akbar	X	_
Akenzua	PROPN	_
Akerele	PROPN	_
Akpabio	PROPN	_
akpalapala	NOUN	_
Akporube	PROPN	_
akpu	NOUN	_
Akure	PROPN	_
Akwa	PROPN	_
al	X	_
Alade	PROPN	_
alapotedly	ADV	_
aldough	SCONJ	_
alert	NOUN	_
alert	VERB	_
Alexis	PROPN	_
Algeria	PROPN	_
alias	ADP	_
alias	NOUN	_
Alibaba	PROPN	_
Alimo	PROPN	_
Alison	PROPN	_
All	PROPN	_
Allah	PROPN	_
Allahu	PROPN	_
Allen	PROPN	_
allocate	VERB	_
Allorchiah	PROPN	_
allright	ADV	_
alms	NOUN	_
alot	ADJ	_
Amachara	PROPN	_
ambassador	NOUN	_
ambipur	NOUN	_
ambitions	NOUN	Number=Plur
amebo	ADJ	_
American	ADJ	_
Americans	PROPN	Number=Plur
Amhohia	PROPN	_
analysis	NOUN	_
Anambra	PROPN	_
ANAN	PROPN	_
anger	NOUN	_
ankara	NOUN	_
Ann	PROPN	_
anniversary	NOUN	_
announce	VERB	_
announcement	NOUN	_
annuity	NOUN	_
Anti	PROPN	_
Antonio	PROPN	_
Anyim	PROPN	_
apala	NOUN	_
APC	PROPN	_
apo	X	_
Apochi	PROPN	_
Aposu	PROPN	_
app	NOUN	_
apple	NOUN	_
appoint	VERB	_
appreciate	VERB	_
approval	NOUN	_
approve	VERB	_
April	PROPN	_
ara]	PUNCT	_
Area	PROPN	_
areas	NOUN	Number=Plur
arm	NOUN	_
armpit	NOUN	_
art	NOUN	_
arthritis	NOUN	_
artist	NOUN	_
arts	NOUN	Number=Plur
arugbo	X	_
ash	NOUN	_
Ash	PROPN	_
ashes	NOUN	Number=Plur
Asonto	PROPN	_
aspire	VERB	_
Assemble	PROPN	_
assemblies	NOUN	Number=Plur
assembly	NOUN	_
Assembly	PROPN	_
assess	VERB	_
assessment	NOUN	_
assist	VERB	_
Assistant	PROPN	_
association	NOUN	_
Association	PROPN	_
Assurance	PROPN	_
athlete	NOUN	_
ATM	NOUN	_
attach	VERB	_
attack	NOUN	_
attack	VERB	_
attempt	NOUN	_
attempted	VERB	Tense=Past|VerbForm=Part
attempting	VERB	Tense=Pres|VerbForm=Part
attention	NOUN	_
attentively	ADV	_
attire	NOUN	_
attraction	NOUN	_
Auchi	PROPN	_
Audu	PROPN	_
August	PROPN	_
auntie	NOUN	_
austerity	NOUN	_
Authority	PROPN	_
auzomahbiah	NOUN	_
available	ADJ	_
avera-	ADJ	_
average	ADJ	_
average	NOUN	_
avian	ADJ	_
avoid	VERB	_
Awa	PROPN	_
award	VERB	_
awareness	NOUN	_
away	ADV	_
Awoyaya	PROPN	_
Ayaniyi	PROPN	_
Ayatollah	PROPN	_
aye	INTJ	_
Ayo	PROPN	_
Ayodeji	PROPN	_
Ayodele	PROPN	_
Aztech	PROPN	_
B	NOUN	_
Babandele	PROPN	_
Babatunde	PROPN	_
Babba	PROPN	_
background	NOUN	_
backing	VERB	Tense=Pres|VerbForm=Part
baddest	ADJ	Degree=Sup
badness	NOUN	_
Bafana	PROPN	_
bags	NOUN	Number=Plur
bail	VERB	_
ballot	NOUN	_
bam	ADJ	_
banana	NOUN	_
band	NOUN	_
Bank	PROPN	_
banking	NOUN	_
bante	X	_
baranda	NOUN	_
barb	VERB	_
Bariga	PROPN	_
barrack	NOUN	_
barracks	NOUN	Number=Plur
Bartholomew	PROPN	_
based	VERB	Tense=Past|VerbForm=Part
basic	ADJ	_
basin	NOUN	_
Basin	PROPN	_
basis	NOUN	_
Bassey	PROPN	_
Batman	PROPN	_
battery	NOUN	_
Bauchi	PROPN	_
Baxter	PROPN	_
BBC	PROPN	_
be-	X	_
becoming	VERB	Tense=Pres|VerbForm=Part
bedroom	NOUN	_
beef	NOUN	_
behalf	NOUN	_
behaviour	NOUN	_
behind	ADP	_
beletete	NOUN	_
bellefulling	NOUN	_
Bello	PROPN	_
belong	VERB	_
Ben	PROPN	_
bench	NOUN	_
bend	VERB	_
Benjamin	PROPN	_
berekete	ADJ	_
beriberi	NOUN	_
Berlin	PROPN	_
Bethany	PROPN	_
beyond	ADP	_
bi-	X	_
bicycle	NOUN	_
Big	PROPN	_
biggest	ADJ	Degree=Sup
billing	NOUN	_
billionaire's	NOUN	_
bingo	NOUN	_
bird	NOUN	_
biro	NOUN	_
bitterleaf	NOUN	_
bittter	ADJ	_
blackboard	NOUN	_
blend	NOUN	_
blend	VERB	_
blessing	NOUN	_
blind	ADJ	_
blouse	NOUN	_
blower	NOUN	_
blowing	VERB	Tense=Pres|VerbForm=Part
blue	NOUN	_
board	NOUN	_
Board	PROPN	_
boast	VERB	_
bodi	NOUN	_
Bodija	PROPN	_
bodyguard	NOUN	_
bodyguards	NOUN	Number=Plur
boiled	VERB	Tense=Past|VerbForm=Part
bold	ADJ	_
bomber	NOUN	_
bombing	NOUN	_
bonga	NOUN	_
bonnet	NOUN	_
Book	PROPN	_
books	NOUN	Number=Plur
boost	VERB	_
booster	NOUN	_
borders	NOUN	Number=Plur
bore	NOUN	_
Bose	PROPN	_
boss	NOUN	_
both	CCONJ	_
both	DET	_
bother	VERB	_
Botswana	PROPN	_
bottom	NOUN	_
boundary	NOUN	_
boutiques	NOUN	Number=Plur
box	NOUN	_
boxers	NOUN	Number=Plur
boyi	NOUN	_
br-	X	_
bracelet	NOUN	_
bracelets	NOUN	Number=Plur
brag	VERB	_
brainwash	VERB	_
brake	VERB	_
branch	VERB	_
branches	NOUN	Number=Plur
Brass	PROPN	_
Bread	PROPN	_
breaking	VERB	Tense=Pres|VerbForm=Part
breathe	VERB	_
brew	VERB	_
bribing	VERB	Tense=Pres|VerbForm=Part
bridge	NOUN	_
brighten	VERB	_
Brilla	PROPN	_
bringing	VERB	Tense=Pres|VerbForm=Part
broad	ADJ	_
Broder	PROPN	_
Bronze	PROPN	_
bu-	X	_
buba	NOUN	_
Bubakari	PROPN	_
bubble	VERB	_
bubble	NOUN	_
bucket	NOUN	_
bucks	NOUN	Number=Plur
built	VERB	_
Bukola	PROPN	_
burst	NOUN	_
burst	VERB	_
Buruji	PROPN	_
bushman	NOUN	_
businesses	NOUN	Number=Plur
buta	NOUN	_
butcher	NOUN	_
bye	INTJ	_
C	NOUN	_
cabal	NOUN	_
cabbage	NOUN	_
cable	NOUN	_
caburator	NOUN	_
cack	VERB	_
cage	NOUN	_
Calabar	PROPN	_
calculate	NOUN	_
calculate	VERB	_
called	VERB	Tense=Past|VerbForm=Part
callers	NOUN	Number=Plur
calling	NOUN	_
Cameroon	PROPN	_
canal	NOUN	_
cancel	VERB	_
candidate	NOUN	_
candidates	NOUN	Number=Plur
candle	NOUN	_
cane	NOUN	_
cannot	AUX	_
canoe	NOUN	_
can't	AUX	_
capacity	NOUN	_
captain	NOUN	_
capture	VERB	_
carburetor	NOUN	_
career	NOUN	_
carpet	NOUN	_
carpets	NOUN	Number=Plur
carrot	NOUN	_
carrying	VERB	Tense=Pres|VerbForm=Part
cars	NOUN	Number=Plur
cartoon	NOUN	_
cast	VERB	_
Cat	PROPN	_
catfish	NOUN	_
caustic	ADJ	_
Cavani	PROPN	_
CBN	PROPN	_
Cement	PROPN	_
Central	PROPN	_
Centre	PROPN	_
CEO	PROPN	_
ceremony	NOUN	_
certificate	NOUN	_
Certificate	PROPN	_
Chad	PROPN	_
chairmo	NOUN	_
chairs	NOUN	Number=Plur
chamber	NOUN	_
Chamo	PROPN	_
Champions'	PROPN	_
changed	NOUN	Tense=Past|VerbForm=Part
character	NOUN	_
cheek	NOUN	_
Chi-	PROPN	_
Chibok	PROPN	_
chick	NOUN	_
chicks	NOUN	Number=Plur
Chief	PROPN	_
Chiefs	PROPN	_
chikini	NOUN	_
child	NOUN	_
childs	NOUN	Number=Plur
Chima	PROPN	_
China	PROPN	_
Chinese	ADJ	_
chips	NOUN	Number=Plur
choose	VERB	_
chopping	NOUN	_
chopulate	VERB	_
chow	VERB	_
churches	NOUN	Number=Plur
cigar	NOUN	_
circulate	VERB	_
circumstance	NOUN	_
clash	VERB	_
classroom	NOUN	_
cle-	ADJ	_
cleaner	NOUN	_
client	NOUN	_
climate	NOUN	_
climbing	VERB	Tense=Pres|VerbForm=Part
clock	NOUN	_
closed	VERB	Tense=Past|VerbForm=Part
closing	VERB	Tense=Pres|VerbForm=Part
clothes	NOUN	Number=Plur
clothing	NOUN	_
clothings	NOUN	Number=Plur
Club	PROPN	_
CMS	PROPN	_
CNPP	PROPN	_
co	AUX	_
cocoa	NOUN	_
Co-commander	PROPN	_
coconut	VERB	_
cocoyam	NOUN	_
code	NOUN	_
code	VERB	_
coded	VERB	Tense=Past|VerbForm=Part
coinage	NOUN	_
collabo	NOUN	_
collar	NOUN	_
College	PROPN	_
com	NOUN	_
comedian	NOUN	_
comedy	NOUN	_
comma	NOUN	_
Command	PROPN	_
commandant	NOUN	_
commander	NOUN	_
Commander	PROPN	_
commend	VERB	_
commercial	ADJ	_
commission	NOUN	_
Commission	PROPN	_
commissioner	NOUN	_
commitment	NOUN	_
committee	NOUN	_
Committee	PROPN	_
commot	VERB	_
communal	ADJ	_
communicate	NOUN	_
communicate	VERB	_
communities	NOUN	Number=Plur
compensate	VERB	_
competition	NOUN	_
complex	NOUN	_
comply	VERB	_
compose	VERB	_
Comprehensive	PROPN	_
Comrade	PROPN	_
concede	VERB	_
concentrate	VERB	_
concerning	VERB	Tense=Pres|VerbForm=Part
condemn	VERB	_
condition	NOUN	_
conductor	NOUN	_
Conference	PROPN	_
confidence	NOUN	_
confirmate	VERB	_
confirmed	VERB	Tense=Past|VerbForm=Part
confuse	VERB	_
confusion	NOUN	_
congratulate	VERB	_
Congress	PROPN	_
connive	VERB	_
conquer	VERB	_
considerate	NOUN	_
consistency	NOUN	_
constant	ADJ	_
constitution	NOUN	_
consulting	NOUN	_
containing	VERB	_
Conte	PROPN	_
continuity	NOUN	_
Controller	PROPN	_
cooperate	VERB	_
		_
Cooperation	PROPN	_
cooperative	NOUN	_
Copa	PROPN	_
core	ADJ	_
Corinthians	PROPN	_
cornerside	ADP	_
Corp	PROPN	_
Corps	PROPN	_
Corruption	PROPN	_
costly	ADJ	_
cosy	NOUN	_
could	AUX	_
council	NOUN	_
Council	PROPN	_
councillor	NOUN	_
count	VERB	_
couple	NOUN	_
courses	NOUN	Number=Plur
court	NOUN	_
Court	PROPN	_
courtesy	NOUN	_
covenant	NOUN	_
cowtail	NOUN	_
cr-	NOUN	_
creator	NOUN	_
credit	NOUN	_
crew	NOUN	_
criminal	NOUN	_
crisis	NOUN	_
Cristiano	PROPN	_
critical	ADJ	_
criticise	VERB	_
CRK	PROPN	_
croocroo	NOUN	_
crown	VERB	_
crucify	VERB	_
crude	ADJ	_
crude	NOUN	_
crumble	VERB	_
crumbles	NOUN	Number=Plur
crypto	NOUN	_
cryptocurrency	NOUN	_
cube	NOUN	_
Cultural	PROPN	_
cup	NOUN	_
Cup	PROPN	_
Cupa	PROPN	_
cups	NOUN	Number=Plur
curator	NOUN	_
currency	NOUN	_
current	ADJ	_
current	NOUN	_
currently	ADV	_
curse	NOUN	_
curse	VERB	_
CWO	PROPN	_
cylinder	NOUN	_
D	NOUN	_
daadaa	X	_
dabaru	VERB	_
Daddy	PROPN	_
dai	INTJ	_
daily	ADJ	_
dances	NOUN	Number=Plur
danger	NOUN	_
dangerous	ADJ	_
dangerously	ADV	_
danjuma	NOUN	_
dark	NOUN	_
darkness	NOUN	_
dash	NOUN	_
Day	PROPN	_
deaf	ADJ	_
death	NOUN	_
debentures	NOUN	Number=Plur
debit	PRON	_
Deborah	PROPN	_
decision	NOUN	_
deep	ADJ	_
Deep	PROPN	_
degree	NOUN	_
deirsef	PRON	Case=Acc|Number=Plur|Person=3|PronType=Prs|Reflex=Yes
del	PROPN	_
delicacy	NOUN	_
deliverance	NOUN	_
Department	PROPN	_
departmental	ADJ	_
depending	VERB	Tense=Pres|VerbForm=Part
deprive	VERB	_
Deputy	PROPN	_
derail	VERB	_
desert	NOUN	_
desert	VERB	_
designed	VERB	Tense=Past|VerbForm=Part
desire	NOUN	_
desk	NOUN	_
despite	ADP	_
destiny	NOUN	_
determination	NOUN	_
determine	VERB	_
device	NOUN	_
di-	X	_
dial	VERB	_
dialysis	NOUN	_
diction	NOUN	_
Didebey	PROPN	_
didn't	AUX	_
diedesi	NOUN	_
diesel	NOUN	_
differences	NOUN	_
dig	VERB	_
Digging	PROPN	9
dimensional	ADJ	_
direct	ADJ	_
directly	NOUN	_
director	NOUN	_
Director	PROPN	_
Directorate	PROPN	_
disappear	NOUN	_
discipline	NOUN	_
discipline	VERB	_
discouraged	VERB	Tense=Past|VerbForm=Part
discriminate	VERB	_
disease	NOUN	_
disheartening	VERB	Tense=Pres|VerbForm=Part
disolve	VERB	_
disrespect	NOUN	_
distance	NOUN	_
distribute	VERB	_
divided	VERB	Tense=Past|VerbForm=Part
divine	ADJ	_
D-Morris	PROPN	_
doable	ADJ	_
Doctor	PROPN	_
Dokubo	PROPN	_
dollars	NOUN	Number=Plur
domiciliary	ADJ	_
domot	NOUN	_
Dondeli	PROPN	_
donkey	ADJ	_
dormitory	NOUN	_
doro	NOUN	_
dot	NOUN	_
double	ADJ	_
doubling	VERB	Tense=Pres|VerbForm=Part
downfall	NOUN	_
dragging	NOUN	_
drain	NOUN	_
drainage	NOUN	_
dream	NOUN	_
dream	VERB	_
dressing	NOUN	_
drivers	NOUN	Number=Plur
driving	VERB	Tense=Pres|VerbForm=Part
drug	NOUN	_
drum	NOUN	_
drummer	NOUN	_
drummers	NOUN	Number=Plur
drumstick	NOUN	_
DSS	PROPN	_
du-	X	_
dubule	NOUN	_
duck	NOUN	_
due	ADP	_
Duke	PROPN	_
dulling	VERB	Tense=Pres|VerbForm=Part
dumb	ADJ	_
dupe	VERB	_
duration	NOUN	_
dust	NOUN	_
duty	NOUN	_
dynamite	NOUN	_
E	NOUN	_
Eagles	PROPN	_
earlier	ADV	Degree=Cmp
earn	VERB	_
earning	NOUN	_
easier	ADV	Degree=Cmp
ebe	X	_
ebot	NOUN	_
economic	ADJ	_
Economic	PROPN	_
economically	ADV	_
Eda	PROPN	_
ede	NOUN	_
edede	NOUN	_
Edewo	PROPN	_
Edewoh	PROPN	_
edikaikon	NOUN	_
Edinson	PROPN	_
editing	NOUN	_
Education	PROPN	_
Efangha	PROPN	_
EFCC	PROPN	_
effective	ADJ	_
effort	NOUN	_
efforts	NOUN	Number=Plur
ego	NOUN	_
"eh	INTJ	_
ehi	X	_
ehu	INTJ	_
ehw	INTJ	_
eider	CCONJ	_
eighteen	NUM	_
eighteenth	ADJ	NumType=Ord
eiss	VERB	_
ekelebe	NOUN	_
Ekiti	PROPN	_
Elder	PROPN	_
eleba	NOUN	_
elect	VERB	_
Electoral	PROPN	_
electric	ADJ	_
electricity	NOUN	_
electronic	ADJ	_
electronics	NOUN	_
Elenumeta	PROPN	_
eleventh	ADJ	NumType=Ord
embarrassing	VERB	Tense=Pres|VerbForm=Part
emerge	VERB	_
emergency	NOUN	_
Emmanuel	PROPN	_
employer	NOUN	_
empty	ADJ	_
en-	X	_
enemy	NOUN	_
energy	NOUN	_
Energy	PROPN	_
engage	VERB	_
engine	NOUN	_
enhance	VERB	_
eni	X	_
enroll	VERB	_
ensure	VERB	_
enta	VERB	_
entice	VERB	_
enu	X	_
epankwokwo	NOUN	_
epurutepu	NOUN	_
equate	VERB	_
er	INTJ	_
era	NOUN	_
eremu	NOUN	_
eri	NOUN	_
ero	INTJ	_
err	VERB	_
escape	VERB	_
e-services	NOUN	Number=Plur
essence	NOUN	_
establishment	NOUN	_
estate	NOUN	_
ethnic	ADJ	_
etin-	X	_
eucharistic	ADJ	_
European	ADJ	_
euros	NOUN	Number=Plur
Eva	PROPN	_
Eve	PROPN	_
event	NOUN	_
Event	PROPN	_
events	NOUN	Number=Plur
eventually	ADV	_
everly	ADV	_
Everton	PROPN	_
everyone	PRON	_
everyt-	PRON	_
everyti-	PRON	_
evidence	NOUN	_
evil	ADJ	_
Ewere	PROPN	_
ewo	INTJ	_
Examination	PROPN	_
excel	VERB	_
exclamation	NOUN	_
excuse	NOUN	_
Executive	PROPN	_
exercise	NOUN	_
exist	VERB	_
expire	VERB	_
expiry	NOUN	_
expose	VERB	_
express	ADJ	_
express	VERB	_
expressional	ADJ	_
ex-soldier	NOUN	_
extension	NOUN	_
External	PROPN	_
eya	INTJ	_
Eyinaya	PROPN	_
Eze	PROPN	_
F	NOUN	_
Fabian	PROPN	_
faced	VERB	Tense=Past|VerbForm=Part
fake	ADJ	_
Falomo	PROPN	_
Famyes	PROPN	_
fan	NOUN	_
fans	NOUN	Number=Plur
farmers	NOUN	Number=Plur
Farmers	PROPN	_
farming	NOUN	_
fasted	VERB	Tense=Past|VerbForm=Part
fasting	NOUN	_
Father	PROPN	_
favourite	ADJ	_
Fayose	PROPN	_
February	PROPN	_
federation	NOUN	_
feet	NOUN	Number=Plur
Femi	PROPN	_
fertilizer	NOUN	_
Festival	PROPN	_
festivity	NOUN	_
few	DET	_
Fidelis	PROPN	_
Fidelity	PROPN	_
field	NOUN	_
FIFA	PROPN	_
fifteen	NUM	_
figures	NOUN	Number=Plur
fill	VERB	_
filling	NOUN	_
fin-	VERB	_
financial	ADJ	_
finger	NOUN	_
fingerlady	NOUN	_
fini-	VERB	_
finished	VERB	Mood=Ind|Tense=Past|VerbForm=Fin
Fire	PROPN	_
fitila	NOUN	_
fix	VERB	_
flash	VERB	_
flenjo	VERB	_
flesh	NOUN	_
flex	VERB	_
flight	NOUN	_
flog	VERB	_
floor	NOUN	_
Florentino	PROPN	_
flu	NOUN	_
fly	VERB	_
flyer	NOUN	_
fo-	X	_
foam	NOUN	_
fold	VERB	_
foodstuff	NOUN	_
fool	VERB	_
foolish	ADJ	_
forefront	NOUN	_
forehead	NOUN	_
foreign	ADJ	_
Foreign	PROPN	_
Forest	PROPN	_
formal	ADJ	_
forms	NOUN	_
Fortwiter	PROPN	_
foundation	NOUN	_
fourty	NUM	_
fowl	NOUN	_
FR	PROPN	_
Fr-	X	_
fractions	NOUN	Number=Plur
France	NOUN	_
fraud	NOUN	_
Fren-	PROPN	_
Friday	PROPN	_
Fridays	PROPN	Number=Plur
fried	VERB	Tense=Pres|VerbForm=Part
fries	NOUN	Number=Plur
Front	PROPN	_
FRSC	PROPN	_
fruit	NOUN	_
frustrated	VERB	Tense=Past|VerbForm=Part
fufu	NOUN	_
fun	NOUN	_
fund	NOUN	_
fund	VERB	_
Funmi	PROPN	_
funny	ADJ	_
G	NOUN	_
g-	X	_
galadima	NOUN	_
gallery	NOUN	_
gallop	NOUN	_
gang	NOUN	_
gari	NOUN	_
Garki	PROPN	_
garments	NOUN	Number=Plur
garnish	VERB	_
gaskett	NOUN	_
gateman	NOUN	_
gave	VERB	Mood=Ind|Tense=Past|VerbForm=Fin
Gaya	PROPN	_
gazillion	NOUN	_
gba	VERB	_
gbab	VERB	_
gbado	NOUN	_
gbadun	VERB	_
gbangain	ADV	_
gbe	NOUN	_
gbege	NOUN	_
gbowo	NOUN	_
gbu	ADJ	_
gbu-	X	_
ge	X	_
gear	NOUN	_
gel	NOUN	_
gel	VERB	_
Gen-	PROPN	_
gene-	NOUN	_
generate	VERB	_
generator	NOUN	_
gentleman	NOUN	_
gentlemen	NOUN	Number=Plur
Geoffrey	PROPN	_
Germain	PROPN	_
German	ADJ	_
Germany	PROPN	_
Ghana	PROPN	_
Ghandi	PROPN	_
ghet-	NOUN	_
Ghost	PROPN	_
giant	NOUN	_
gidan	X	_
gift	NOUN	_
gig	NOUN	_
gist	NOUN	_
giti	X	_
global	ADJ	_
glorious	ADJ	_
gm-	X	_
goal	NOUN	_
goalless	ADJ	_
goals	NOUN	Number=Plur
Godfrey	PROPN	_
gods	NOUN	Number=PLur
God's	PROPN	_
Godswill	PROPN	_
Goemai	PROPN	_
gombodi	NOUN	_
gombodies	NOUN	Number=PLur
gombody	NOUN	_
google	VERB	_
gospel	NOUN	_
got	VERB	Mood=Ind|Tense=Past|VerbForm=Fin
govern	VERB	_
Government	PROPN	_
Governor	PROPN	_
GRA	PROPN	_
Grace	PROPN	_
graduates	NOUN	Number=Plur
grandfader	NOUN	_
grant	VERB	_
grateful	ADJ	_
grave	NOUN	_
grease	NOUN	_
greeting	NOUN	_
groove	NOUN	_
grounded	VERB	Tense=Past|VerbForm=Part
grounding	VERB	Tense= Pres|VerbForm=Part
groundwater	NOUN	_
Group	PROPN	_
groups	NOUN	Number=Plur
growing	VERB	_
growth	NOUN	_
gu-	X	_
guarantee	VERB	_
guards	NOUN	Number=Plur
guest	NOUN	_
guesthouse	NOUN	_
guide	VERB	_
guidelines	NOUN	Number=Plur
guinea	NOUN	_
Guinea	PROPN	_
guitar	NOUN	_
Gulder	PROPN	_
gum	VERB	_
guns	NOUN	Number=Plur
gutter	NOUN	_
guys	NOUN	Number=Plur
gym	NOUN	_
Gym	PROPN	_
Gymnasium	PROPN	_
gyneacologist	NOUN	_
H	NOUN	_
h-	X	_
Habibu	PROPN	_
had	AUX	Mood=Ind|Tense=Past|VerbForm=Fin
Had-	PROPN	_
Hadizatu	PROPN	_
hairdresser	NOUN	_
hairstyle	NOUN	_
hall	NOUN	_
Hall	PROPN	_
handed	VERB	Tense=Past|VerbForm=Part
handkerchief	NOUN	_
hang	VERB	_
happily	ADV	_
happiness	NOUN	_
harass	VERB	_
harassment	NOUN	_
Harcout	PROPN	_
hardest	ADJ	Degree=Sup
hardship	NOUN	_
harmonisation	NOUN	_
harrass	VERB	_
Harry	PROPN	_
harvest	NOUN	_
hatch	VERB	_
hav-	VERB	_
hazard	NOUN	_
Head	PROPN	_
heading	NOUN	_
headquarter	NOUN	_
headquarters	NOUN	Number=Plur
heads	NOUN	Number=Plur
hearts	NOUN	Number=Plur
heavy	ADJ	_
Hebrew	PROPN	_
height	NOUN	_
heiss	INTJ	_
hel-	X	_
helep	VERB	_
hem	INTJ	_
hero	NOUN	_
hide	VERB	_
hiding	VERB	Tense=Pres|VerbForm=Part
High	PROPN	_
higher	ADJ	Degree=Cmp
Hilda	PROPN	_
himsef	PRON	Case=Acc|Person=3|Number=Sing|Reflex=Yes
His	PRON	PronType=Prs|Number=Sing|Person=3
historian	NOUN	_
history	NOUN	_
hm'm	INTJ	_
hmn	INTJ	_
HND	PROPN	_
Ho-	X	_
hole	NOUN	_
holiday	NOUN	_
Hollywood	PROPN	_
Holy	PROPN	_
honest	ADJ	_
honour	NOUN	_
honourable	ADJ	_
hooligans	NOUN	Number=Plur
hopeful	ADJ	_
horn	NOUN	_
horses	NOUN	Number=Plur
hose	NOUN	_
Hospital	PROPN	_
hospitals	NOUN	Number=Plur
hostage	NOUN	_
hotel	NOUN	_
Hotel	PROPN	_
hotting	VERB	Tense=Pres|VerbForm=Part
hour	NOUN	_
House	PROPN	_
housing	NOUN	_
howuhowu	NOUN	_
Huan	PROPN	_
hub-	X	_
hug	VERB	_
huge	ADJ	_
humble	ADJ	_
humour	NOUN	_
hunt	VERB	_
husbandi	NOUN	_
husbands	NOUN	Number=Plur
hussle	VERB	_
Hyde	PROPN	_
hygenic	ADJ	_
I-	X	_
Ian	PROPN	_
Ibeju	PROPN	_
Ibom	PROPN	_
ibon	X	_
Ibrahim	PROPN	_
ICAN	PROPN	_
ID	NOUN	_
identify	VERB	_
Idiala	PROPN	_
idiot	NOUN	_
idunkokomoni	NOUN	_
ifa	PART	_
Ifeyinwa	PROPN	_
igba	X	_
Igbimo	PROPN	_
Igbo	ADJ	_
igbo	NOUN	_
Igbo	PROPN	_
ignorance	NOUN	_
IGP	PROPN	_
Igue	PROPN	_
Ijaw	PROPN	_
ilahlah	INTJ	_
illusions	NOUN	Number=Plur
Ilu	PROPN	_
I'm	AUX	_
Imo	PROPN	_
implicate	VERB	_
importation	NOUN	_
impress	VERB	_
impression	NOUN	_
imself	PRON	Case=Nom|PronType=Prs|Number=Plur|Person=3
ina	X	_
inbuilt	ADJ	_
incantation	NOUN	_
include	VERB	_
income	NOUN	_
indeed	ADV	_
Independent	PROPN	_
Indian	ADJ	_
industry	NOUN	_
Industry	PROPN	_
inf-	X	_
inferiority	NOUN	_
infinite	ADJ	_
Infinix	PROPN	_
inflate	VERB	_
inflation	NOUN	_
informate	NOUN	_
Informations	PROPN	_
infuse	VERB	_
ingred-	X	_
initially	ADV	_
injector	NOUN	_
injure	VERB	_
Inland	PROPN	_
innocent	ADJ	_
ino	X	_
insef	PRON	_
insha	X	_
inso-	X	_
inspect	VERB	_
inst-	X	_
instance	NOUN	_
institution	NOUN	_
instruction	NOUN	_
instrument	NOUN	_
instrumentalists	NOUN	Number=Plur
insurance	NOUN	_
insure	VERB	_
insurgency	NOUN	_
intelligence	NOUN	_
intelligent	ADJ	_
interact	VERB	_
intergovermental	ADJ	_
intermediary	ADJ	_
international	ADJ	_
International	PROPN	_
interviews	NOUN	Number=Plur
Intia	PROPN	_
intimidate	VERB	_
introduce	VERB	_
invasion	NOUN	_
invest	VERB	_
investment	NOUN	_
Investment	PROPN	_
investments	NOUN	Number=Plur
investors	NOUN	Number=Plur
involve	VERB	_
inyanyan	NOUN	_
IPOs	PROPN	_
Iran	PROPN	_
Iranian	ADJ	_
Ireland	PROPN	_
iro	NOUN	_
irogoje	NOUN	_
iron	NOUN	_
irrelevant	ADJ	_
Isaac	PROPN	_
Ishaya	PROPN	_
ISIS	PROPN	_
Islamic	ADJ	_
island	NOUN	_
Isolo	PROPN	_
Israel	PROPN	_
IT	PROPN	_
Ita	PROPN	_
Itsekiri	NOUN	_
itself	PRON	Case=Acc|PronType=Prs|Gender=Neut|Person=3|Reflex=Yes
iwo	NOUN	_
iwuhabia	NOUN	_
iyorominyo	NOUN	_
Iyukui	PROPN	_
jack	NOUN	_
Jacob	PROPN	_
jaguda	NOUN	_
Jamaila	PROPN	_
jambito	NOUN	_
jambitos	NOUN	Number=Plur
jamz	NOUN	_
Jarawa	PROPN	_
Javier	PROPN	_
jegbese	X	_
jeje	NOUN	_
jell	VERB	_
Jemaimah	PROPN	_
jerk	VERB	_
jerking	VERB	Tense=Pres|VerbForm=Part
jersey	NOUN	_
Jerusalem	PROPN	_
jewelleries	NOUN	Number=Plur
jewellery	NOUN	_
Jibike	PROPN	_
jibiti	NOUN	_
jinger	VERB	_
Joel	PROPN	_
John's	PROPN	_
joinbody	VERB	_
Joint	PROPN	_
jointer	NOUN	_
joints	NOUN	Number=Plur
Jojo	PROPN	_
Joke	PROPN	_
joking	VERB	Tense=Pres|VerbForm=Part
jolijoli	NOUN	_
jolloficate	VERB	_
jor	INTJ	_
Jose	PROPN	_
Journalists	PROPN	_
Jovia	PROPN	_
jubilation	NOUN	_
judge	NOUN	_
judge	VERB	_
judgement	NOUN	_
juju	NOUN	_
jumbo	ADJ	_
Junaidu	PROPN	_
June	PROPN	_
justice	NOUN	_
Justina	PROPN	_
ka	X	_
kaabo	X	_
Kabir	PROPN	_
Kabiru	PROPN	_
kabun	NOUN	_
kack	VERB	_
Kaduna	PROPN	_
Kagoro	PROPN	_
kaikai	NOUN	_
Kaiser	PROPN	_
kajad	ADJ	_
kakaraka	ADJ	_
kambia	NOUN	_
kampe	ADJ	_
kanapotelli	X	_
kasa	NOUN	_
Kashamu	PROPN	_
kata	PROPN	_
Katsina	PROPN	_
kaya	NOUN	_
kd	NOUN	_
ke	X	_
kee	X	_
keeper	NOUN	_
Keita	PROPN	_
keke	NOUN	_
Kevwe	PROPN	_
key	NOUN	_
keyin	X	_
ki	X	_
kidnapper	NOUN	_
kidnappers	NOUN	Number=Plur
kidnapping	NOUN	_
Kikelomo	PROPN	_
Kilimanjaro	PROPN	_
kindness	NOUN	_
kins	NOUN	Number=Plur
knack	VERB	_
knowing	VERB	Tense=Pres|VerbForm=Part
knowledge	NOUN	_
kobo	NOUN	_
Kogi	PROPN	_
kolobi	VERB	_
kowaju	X	_
kpake	VERB	_
kpaki	VERB	_
kpako	NOUN	_
kpakpakpa	NOUN	_
kporo	VERB	_
kput	VERB	_
Krest	PROPN	_
kun	X	_
kwarak	NOUN	_
kwulukwulu	INTJ	_
kwulukwulukwuluu	INTJ	_
La	PROPN	_
labour	NOUN	_
Labour	PROPN	_
ladies	NOUN	Number=Plur
lafs	X	_
Lagelu	PROPN	_
lai	INTJ	_
Lai	PROPN	_
laila	X	_
lake	NOUN	_
Lake	PROPN	_
Lala	PROPN	_
lamu	X	_
lands	NOUN	Number=Plur
langua	ADJ	_
languages	NOUN	Number=Plur
lantern	NOUN	_
laraamu	X	_
Lasaco	PROPN	_
lasan	X	_
LASIEC	PROPN	_
launch	VERB	_
law	NOUN	_
lay	VERB	_
laying	VERB	Tense=Pres|VerbForm=Part
laziness	NOUN	_
LCBC	PROPN	_
Le	PROPN	_
leadership	NOUN	_
leak	VERB	_
Lebanese	ADJ	_
lecturers	NOUN	Number=Plur
led	VERB	Mood=Ind|Tense=Past|VerbForm=Fin
ledi	X	_
legit	ADJ	_
Leipzig	PROPN	_
Lekan	PROPN	_
Lekki	PROPN	_
lem	VERB	_
lemon	NOUN	_
length	NOUN	_
Lent	PROPN	_
li-	X	_
liabilities	NOUN	Number=Plur
Libya	PROPN	_
licence	NOUN	_
lifestyle	NOUN	_
lifetime	NOUN	_
Liga	PROPN	_
lighter	NOUN	_
likewise	ADV	_
liking	NOUN	_
Lil-	X	_
Lilian	PROPN	_
limit	NOUN	_
limit	VERB	_
limited	ADJ	Tense=Past|VerbForm=Part
limiting	PRON	Tense=Pres|VerbForm=Part
lingo	NOUN	_
linguist	NOUN	_
liquid	NOUN	_
list	NOUN	_
listening	VERB	Tense=Pres|VerbForm=Part
liter	NUM	_
liters	NOUN	Number=Plur
living	VERB	Tense=Pres|VerbForm=Part
lo	X	_
loaf	NOUN	_
loan	NOUN	_
Local	PROPN	_
lodge	NOUN	_
lodge	VERB	_
lodging	NOUN	_
log	VERB	_
logistic	ADJ	_
lohun	X	_
loi	NOUN	_
looking	VERB	Tense=Pres|VerbForm=Part
loose	VERB	_
lord	NOUN	_
Lord	PROPN	_
loss	NOUN	_
loss	VERB	_
lost	VERB	Tense=Past|VerbForm=Part
lovely	ADJ	_
lowo	X	_
Lucent	PROPN	_
Luchi	PROPN	_
luckily	ADV	_
lucky	ADJ	_
Lucky	PROPN	_
Lukaku	PROPN	_
M	NOUN	_
maa	AUX	_
maaje	X	_
ma-akara	NOUN	_
Macron	PROPN	_
mad-	X	_
made	VERB	Tense=Past|VerbForm=Part
Madrid	PROPN	_
ma-firewood	NOUN	_
magazine	NOUN	_
Maggi	PROPN	_
magic	NOUN	_
magistrate	NOUN	_
mago	NOUN	_
magomago	NOUN	_
Mahatma	PROPN	_
mahnsef	PRON	Gender=Neut|Number=Sing|Person=3|PronType=Prs|Reflex=Yes
makaruru	NOUN	_
maker	NOUN	_
makers	NOUN	Number=Plur
Malay	PROPN	_
Malaysia	PROPN	_
mall	NOUN	_
malpractice	NOUN	_
mami	NOUN	_
Mana	PROPN	_
management	NOUN	_
Manchester	PROPN	_
manual	ADJ	_
manufacture	NOUN	_
Manufacturers	PROPN	_
Maputo	PROPN	_
mara	X	_
March	PROPN	_
Marine	PROPN	_
mark	NOUN	_
mark	VERB	_
Martin	PROPN	_
Mashonaland	PROPN	_
masquerade	NOUN	_
Mata	PROPN	_
match	NOUN	_
match	VERB	_
Mate	PROPN	_
materials	NOUN	Number=Plur
maths	NOUN	_
matric	NOUN	_
Matriculation	PROPN	_
Matrix	PROPN	_
Max	PROPN	_
may	AUX	_
May	PROPN	_
mbanu	X	_
mc	NOUN	_
MC	PROPN	_
md	NOUN	_
meals	NOUN	Number=Plur
meaning	NOUN	_
mechanical	ADJ	_
mechanics	NOUN	Number=Plur
Medical	PROPN	_
medicals	NOUN	Number=Plur
meeting	NOUN	_
melon	NOUN	_
melt	VERB	_
memorise	VERB	_
mention	NOUN	_
mentorship	NOUN	_
mercy	NOUN	_
merge	VERB	_
meself	PRON	Case=Acc|Number=Sing|Person=1|PronType=Prs|Reflex=Yes
mess	VERB	_
Messi	PROPN	_
metal	NOUN	_
mi	X	_
microphone	NOUN	_
mid	ADJ	_
midfielder	NOUN	_
midnight	NOUN	_
might	AUX	_
mild	ADJ	_
mile	NOUN	_
millions	NOUN	Number=Plur
mindful	ADJ	_
minds	NOUN	Number=Plur
mindset	NOUN	_
mini	ADJ	_
minimal	ADJ	_
Minister	PROPN	_
ministry	NOUN	_
Ministry	PROPN	_
mir-	X	_
Miracle	PROPN	_
misbehaving	VERB	Tense=Pres|VerbForm=Part
misinterpret	VERB	_
misplacement	NOUN	_
Mista	PROPN	_
mistakenly	ADV	_
mistakes	NOUN	Number=Plur
Mister	PROPN	_
misunderstanding	NOUN	_
mix	VERB	_
Mixed	PROPN	_
mobile	ADJ	_
mock	ADJ	_
Moder	PROPN	_
Mohammadu	PROPN	_
Momo's	PROPN	_
Mondays	PROPN	Number=Plur
mongers	NOUN	Number=Plur
mop	VERB	_
Mopun	PROPN	_
mor-	X	_
mortgage	NOUN	_
mortgage	VERB	_
Moruf	PROPN	_
Moses	PROPN	_
motion	NOUN	_
mount	VERB	_
Mountain	PROPN	_
Mourinho	PROPN	_
mourn	VERB	_
movie	NOUN	_
movies	NOUN	Number=Plur
moving	VERB	Tense=Pres|VerbForm=Part
mow-	X	_
Mozambique	PROPN	_
MP	NOUN	_
mpempe	ADJ	_
Mr	PROPN	_
Mrs	PROPN	_
MTN	PROPN	_
mu	X	_
mudu	NOUN	_
Mugabe	PROPN	_
Muhamed	PROPN	_
Muhammad	PROPN	_
Muhammadu	PROPN	_
Muhammed	PROPN	_
multiple	ADJ	_
mum	NOUN	_
mummies	NOUN	Number=Plur
mumsie	NOUN	_
mumu	NOUN	_
mumu	VERB	_
muna	X	_
Murtala	PROPN	_
mus	X	_
muscle	NOUN	_
Museum	PROPN	_
music	NOUN	_
musical	ADJ	_
musician	NOUN	_
Muslim	ADJ	_
Mustapha	PROPN	_
Mwaghavul	PROPN	_
naa	X	_
Naby	PROPN	_
nai-	X	_
nain	ADV	_
nan	X	_
nari	NOUN	_
nation	NOUN	_
Nations	PROPN	_
naturally	ADV	_
nature	NOUN	_
nawa	INTJ	_
NAWOJ	PROPN	_
Ndokwa	PROPN	_
nearly	ADV	_
nearness	NOUN	_
neat	ADJ	_
neatly	ADV	_
neck	NOUN	_
negative	ADJ	_
negotiation	NOUN	_
neighbouring	ADJ	_
NEPA	PROPN	_
network	NOUN	_
neutral	ADJ	_
Newsmaker	PROPN	_
newspaper	NOUN	_
Neymar	PROPN	_
ni-	X	_
nicker	NOUN	_
Nicodemus	PROPN	_
Niger	PROPN	_
niggers	NOUN	Number=Plur
nights	NOUN	_
nikan	NOUN	_
nineteen	NUM	NumType=Card
ninety-six	NUM	NumType=Card
NIS	PROPN	_
nise	NOUN	_
NISER	PROPN	_
nitrosol	NOUN	_
NJC	PROPN	_
Nkemjika	PROPN	_
nkor	INTJ	_
NLC	PROPN	_
nn	INTJ	_
NNL	PROPN	_
NNPC	PROPN	_
no-	X	_
noon	NOUN	_
normalise	VERB	_
North	PROPN	_
northern	ADJ	_
Northern	PROPN	_
Northerner	PROPN	_
Norwich	PROPN	_
not-	X	_
note	VERB	_
Notice	PROPN	_
nsala	NOUN	_
nso	ADV	_
nu	PART	_
num-	X	_
Numancia	PROPN	_
numbers	NOUN	Number=Plur
Nwobo	PROPN	_
O	NOUN	_
o-	X	_
O.A.	PROPN	_
O.D.S.	PROPN	_
Oba	PROPN	_
Obi	PROPN	_
object	NOUN	_
obodo	NOUN	_
ocean	NOUN	_
oclock	ADV	_
odas	NOUN	Number=Plur
odd	ADJ	_
odds	NOUN	Number=Plur
oderwise	ADV	_
odetola	NOUN	_
Odion	PROPN	_
odour	NOUN	_
odun	X	_
of-	X	_
ofe	X	_
off	ADP	_
offences	NOUN	Number=Plur
officers	NOUN	Number=Plur
ofofo	NOUN	_
ogbeni	NOUN	_
ogbolo	ADJ	_
ogbonge	ADJ	_
ogbonno	NOUN	_
Ogiator	PROPN	_
Oginmbiri	PROPN	_
ogiri	NOUN	_
ogkuoafan	NOUN	_
ogogoro	NOUN	_
Ogun	PROPN	_
Ogunlade	PROPN	_
Ogunladi	NOUN	_
Ojo	PROPN	_
Ojurin	NOUN	_
OK	INTJ	_
Oka	PROPN	_
okada	NOUN	_
Oko	PROPN	_
oko	X	_
Okorafor	PROPN	_
okporoko	NOUN	_
okra	NOUN	_
okwakwa	NOUN	_
Olabisi	PROPN	_
Olagunju	PROPN	_
oldest	ADJ	Degree=Sup
ologborangandan	NOUN	_
Olomide	PROPN	_
olorun	X	_
Olowookere	PROPN	_
Om-	PROPN	_
Omo	PROPN	_
Omogbai	PROPN	_
Omoku	PROPN	_
Omole	PROPN	_
Omoluabi	PROPN	_
Omowole	PROPN	_
One	PROPN	_
O'neill	PROPN	_
onion	NOUN	_
onise	X	_
online	ADV	_
Onnoghen	PROPN	_
Onoja	PROPN	_
onto	ADP	_
ontop	ADP	_
Onyeama	PROPN	_
opendential	NOUN	_
Operation	PROPN	_
operative	NOUN	_
operatives	NOUN	Number=Plur
Opi	PROPN	_
Opochi	PROPN	_
opposite	ADJ	_
option	NOUN	_
optional	ADJ	_
orange	NOUN	_
order	VERB	_
Ore	PROPN	_
organisation	NOUN	_
organisations	NOUN	Number=Plur
organise	VERB	_
organised	VERB	Tense=Past|VerbForm=Part
organize	VERB	_
Oria-	PROPN	_
Oribanwuwa	PROPN	_
Origin	PROPN	_
originate	VERB	_
Orimolade	PROPN	_
orisirisi	NOUN	_
oro-	X	_
Osoesan	PROPN	_
Ossai	PROPN	_
Osun	PROPN	_
otaiko	NOUN	_
otong	NOUN	_
Otuyi	PROPN	_
ouside	ADP	_
outbreak	NOUN	_
outcast	NOUN	_
overall	ADJ	_
overhead	ADJ	_
overheating	NOUN	_
overload	NOUN	_
overpower	VERB	_
oversee	VERB	_
overseer	NOUN	_
overspeeding	NOUN	_
overture	NOUN	_
owes	VERB	Mood=Ind|Number=Sing|Person=3|Tense=Pres|VerbForm=Fin
owner	NOUN	_
owners	NOUN	Number=Plur
Oyama	PROPN	_
Oyebade	PROPN	_
oyibo	ADJ	_
Oyibo	PROPN	_
Oyo	PROPN	_
oyoyo	X	_
ozigi	NOUN	_
Ozil	PROPN	_
ozobuko	NOUN	_
P	NOUN	_
PA	NOUN	_
pa-	X	_
packing	NOUN	_
page	NOUN	_
pah	INTJ	_
pakan	ADV	_
pakaso	VERB	_
pala	NOUN	_
pala-	NOUN	_
palava	NOUN	_
pale	NOUN	_
pali	NOUN	_
palm	NOUN	_
palmy	NOUN	_
Pan	PROPN	_
Pankshin	PROPN	_
Papa	PROPN	_
papapa	NOUN	_
para	VERB	_
parile	X	_
Paris	PROPN	_
pariwo	X	_
Park	PROPN	_
parliament	NOUN	_
Parliament	PROPN	_
parlour	NOUN	_
parole	NOUN	_
parsee	NOUN	_
particular	ADJ	_
parties	NOUN	_
Parties	PROPN	_
passengers	NOUN	Number=Plur
passion	NOUN	_
Passover	PROPN	_
passport	NOUN	_
password	NOUN	_
paste	NOUN	_
Pastore	PROPN	_
patapata	ADV	_
Patrick	PROPN	_
patronise	VERB	_
patronize	VERB	_
Paul	PROPN	_
Paulina	PROPN	_
Pay	PROPN	_
payment	NOUN	_
pe	X	_
pee	VERB	_
peel	VERB	_
peer	NOUN	_
pekele	X	_
pele	VERB	_
peletete	NOUN	_
pelu	NOUN	_
pen	NOUN	_
Pen	PROPN	_
peo-	NOUN	_
people's	NOUN	_
peppersoup	NOUN	_
perceive	VERB	_
percent	NOUN	_
pere	ADV	_
perform	VERB	_
performance	NOUN	_
perish	VERB	_
permanent	ADJ	_
Permanent	PROPN	_
perseverance	NOUN	_
personalise	VERB	_
persons	NOUN	Number=Plur
perspective	NOUN	_
pesticide	NOUN	_
pet	NOUN	_
petrol	NOUN	_
petty	ADJ	_
pharmacist	NOUN	_
phase	NOUN	_
philosophy	NOUN	_
phones	NOUN	Number=Plur
phrase	NOUN	_
pi-	NOUN	_
picking	VERB	Tense=Pres|VerbForm=Part
Pieres	PROPN	_
pik-	NOUN	_
Pikin	PROPN	_
pile	NOUN	_
pillars	NOUN	Number=Plur
pilot	NOUN	_
piloting	NOUN	_
pin	NOUN	_
pin	VERB	_
pink	ADJ	_
Piriye	PROPN	_
Pisa	PROPN	_
piss	VERB	_
piston	NOUN	_
pla-	NOUN	_
plaiting	NOUN	_
plane	NOUN	_
plans	NOUN	Number=Plur
plant	NOUN	_
plant	VERB	_
plaster	VERB	_
plastic	NOUN	_
platform	NOUN	_
PLC	PROPN	_
pleasurable	ADJ	_
pleasure	NOUN	_
plier	NOUN	_
pluck	VERB	_
plug	NOUN	_
pm	NOUN	_
po	X	_
pockets	NOUN	Number=Plur
poem	NOUN	_
poems	NOUN	Number=Plur
Point	PROPN	_
pol-	NOUN	_
policy	policy	_
polish	VERB	_
political	ADJ	_
Political	PROPN	_
politics	NOUN	_
polongo	VERB	_
Poly	PROPN	_
Polytechnic	PROPN	_
pond	NOUN	_
Ponzi	PROPN	_
pool	NOUN	_
pop	NOUN	_
popular	ADJ	_
Porico	PROPN	_
Portharcourt	PROPN	_
Port-Harcourt	PROPN	_
portion	NOUN	_
poto	NOUN	_
poultry	NOUN	_
pounds	NOUN	Number=Plur
poverty	NOUN	_
practice	NOUN	_
practise	VERB	_
praise	VERB	_
pre-	NOUN	_
precious	ADJ	_
precise	NOUN	_
precisely	ADV	_
predict	VERB	_
prediction	NOUN	_
prefer	VERB	_
pregnancy	NOUN	_
preparation	NOUN	_
President	PROPN	_
presidential	ADJ	_
Presidential	PROPN	_
presiding	VERB	Tense=Pres|VerbForm=Part
presido	NOUN	_
Presido	PROPN	_
pressable	ADJ	_
pressure	NOUN	_
prevent	VERB	_
pride	NOUN	_
principle	NOUN	_
priorities	NOUN	Number=Plur
priority	NOUN	_
privilege	NOUN	_
pro	DET	_
proccess	NOUN	_
produce	VERB	_
product	NOUN	_
production	NOUN	_
prof	NOUN	_
profe-	NOUN	_
professional	ADJ	_
professionally	ADV	_
professionals	NOUN	Number=Plur
professor	NOUN	_
Progressive	PROPN	_
project	NOUN	_
Project	PROPN	_
pronounce	VERB	_
property	NOUN	_
prophecy	NOUN	_
Prophet	PROPN	_
prophet	VERB	_
propose	VERB	_
prosecute	VERB	_
prosecuting	VERB	Tense=Pres|VerbForm=Part
prosperity	NOUN	_
protection	NOUN	_
proud	ADJ	_
proverb	SCONJ	_
proverbial	ADJ	_
proverbs	NOUN	Tense=Pres|VerbForm=Part
provide	VERB	_
Psalm	PROPN	_
pshew	INTJ	_
psychologist	NOUN	_
psychology	NOUN	_
pu-	VERB	_
publicity	NOUN	_
puh	INTJ	_
puma	NOUN	_
pump	VERB	_
Punch	PROPN	_
punishment	NOUN	_
pupils	NOUN	Number=Plur
pupsie	NOUN	_
pupsy	NOUN	_
purple	NOUN	_
purpose	NOUN	_
purse	NOUN	_
pus	NOUN	_
Pus	PROPN	_
putting	VERB	Tense=Pres|VerbForm=Part
qualifier	NOUN	_
quantity	NOUN	_
Queens	PROPN	_
questions	NOUN	Number=Plur
quit	VERB	_
quota	NOUN	_
R	NOUN	_
race	NOUN	_
racket	NOUN	_
radiator	NOUN	_
Radio	PROPN	_
rag	NOUN	_
rainy	ADJ	_
raise	VERB	_
rake	VERB	_
ransom	NOUN	_
rape	NOUN	_
rape	VERB	_
raping	VERB	Tense=Pres|VerbForm=Part
rapper	NOUN	_
rashes	NOUN	Number=Plur
rat	NOUN	_
raw	ADJ	_
RB	NOUN	_
re	VERB	_
re	X	_
reach	X	_
Real	PROPN	_
realise	VERB	_
realize	VERB	_
Rear	PROPN	_
rearrange	VERB	_
recall	VERB	_
Red	NOUN	_
Redeem	PROPN	_
reference	NOUN	_
reggae	NOUN	_
Registrar	PROPN	_
regret	VERB	_
regular	ADJ	_
regulate	VERB	_
rehearsal	NOUN	_
reign	VERB	_
reincarnate	VERB	_
relate	VERB	_
relation	NOUN	_
relations	NOUN	Number=Plur
release	VERB	_
relevant	ADJ	_
rely	VERB	_
remit	VERB	_
remote	NOUN	_
render	VERB	_
renew	VERB	_
reorientate	VERB	_
reorientation	NOUN	_
rep	NOUN	_
repair	NOUN	_
repair	VERB	_
repeat	VERB	_
repre-	NOUN	_
represent	VERB	_
representate	NOUN	_
representative	NOUN	_
Representative	PROPN	_
representatives	NOUN	Number=Plur
Republic	PROPN	_
rescue	VERB	_
rescued	VERB	Tense=Past|VerbForm=Part
resemble	VERB	_
reservation	NOUN	_
reserve	VERB	_
residence	NOUN	_
resign	VERB	_
resolve	VERB	_
resources	NOUN	Number=Plur
restaurant	NOUN	_
restructuring	NOUN	_
reti	X	_
retire	VERB	_
Revenue	PROPN	_
reverend	NOUN	_
review	VERB	_
revolve	VERB	_
rewinding	NOUN	_
Rey	PROPN	_
RI-	NOUN	_
Rice	PROPN	_
richest	ADJ	Degree=Sup
ride	VERB	_
Rier	PROPN	_
Right	PROPN	_
ring	NOUN	_
ripe	ADJ	_
rise	VERB	_
rising	VERB	Tense=Pres|VerbForm=Part
risk	NOUN	_
risk	VERB	_
risks	NOUN	Number=Plur
rituals	NOUN	Number=Plur
Rivers	PROPN	_
RMU	NOUN	_
roam	VERB	_
robbers	NOUN	Number=Plur
Robota	PROPN	_
rod	NOUN	_
rogoje	NOUN	_
roll	VERB	_
root	NOUN	_
Rovers	PROPN	_
rua	X	_
rub	VERB	_
rumour	NOUN	_
rumours	NOUN	Number=Plur
rushing	NOUN	_
S	NOUN	_
S.	PROPN	_
SA	PROPN	_
sa-	VERB	_
saanu	X	_
safety	NOUN	_
Safety	PROPN	_
Sahara	PROPN	_
said	VERB	Mood=Ind|Tense=Past|VerbForm=Fin
Saint	PROPN	_
salad	NOUN	_
sale	NOUN	_
sales	NOUN	Number=Plur
Salomi	PROPN	_
Sam	PROPN	_
sama	VERB	_
Samshudeen	PROPN	_
Samuel	PROPN	_
san	X	_
sanu	X	_
Sapele	NOUN	_
Sapientia	PROPN	_
Sara	PROPN	_
Saraki	PROPN	_
Satan	PROPN	_
satellite	NOUN	_
Saturday	PROPN	_
Saturdays	PROPN	Number=Plur
sausage	NOUN	_
savings	NOUN	Number=Plur
saying	VERB	Tense=Pres|VerbForm=Part
says	ADJ	Mood=Ind|Number=Sing|Person=3|Tense=Pres|VerbForm=Fin
scapegoat	NOUN	_
scarcity	NOUN	_
scared	VERB	Tense=Past|VerbForm=Part
scattered	ADJ	Tense=Past|VerbForm=Part
schedule	NOUN	_
Scheme	PROPN	_
scholarship	NOUN	_
scissors	NOUN	Number=Plur
scope	NOUN	_
scopew	NOUN	_
scopew	VERB	_
screwdriver	NOUN	_
script	NOUN	_
se	X	_
searching	VERB	Tense=Pres|VerbForm=Part
seasoning	NOUN	_
seat	NOUN	_
seater	NOUN	_
seats	NOUN	Number=Plur
sebi	PART	_
sece	NOUN	_
Secondary	PROPN	_
secondly	ADV	_
seconds	NOUN	Number=Plur
Secretary	PROPN	_
section	NOUN	_
sector	NOUN	_
secular	ADJ	_
seed	NOUN	_
seen	VERB	Tense=Past|VerbForm=Part
sele	VERB	_
selfish	ADJ	_
selfishly	ADV	_
semi	ADJ	_
seminar	NOUN	_
seminars	NOUN	Number=Plur
Senate	PROPN	_
senator	NOUN	_
Senior	PROPN	_
sensitive	NUM	_
Senyatuwe	PROPN	_
separate	VERB	_
September	PROPN	_
SERAP	PROPN	_
Sergeant	PROPN	_
seriously	ADV	_
seriousness	NOUN	_
servant	VERB	_
Service	PROPN	_
Services	PROPN	_
session	NOUN	_
setting	NOUN	_
setting	VERB	Tense=Pres|VerbForm=Part
Seven	NOUN	NumType=Card
seyi	X	_
sh-	VERB	_
shaki	NOUN	_
shall	AUX	_
shapadly	ADJ	_
sharperly	ADJ	_
shawarma	NOUN	_
Shawarma	PROPN	_
shekele	ADJ	_
shekpe	NOUN	_
shele	VERB	_
Shell	PROPN	_
shere	ADJ	_
shi	X	_
shifting	NOUN	_
shikini	ADJ	_
shoes	NOUN	Number=Plur
shook	VERB	_
shorten	VERB	_
shots	NOUN	Number=Plur
shouldn't	AUX	_
shows	NOUN	Number=Plur
shuffle	VERB	_
shugaban	NOUN	_
shun	VERB	_
si	X	_
si-	VERB	_
sides	NOUN	Number=Plur
sidon	VERB	_
sight	VERB	_
signify	VERB	_
signing	VERB	Tense=Pres|VerbForm=Part
silva	NOUN	_
Silva	PROPN	_
Silver	PROPN	_
simbo	INTJ	_
similar	ADJ	_
similar	VERB	_
simply	ADV	_
singer	NOUN	_
sink	VERB	_
sio	ADJ	_
sip	VERB	_
sista	NOUN	_
Six	PROPN	_
size	NOUN	_
Skata	PROPN	_
slangs	NOUN	Number=Plur
slate	NOUN	_
slates	NOUN	Number=Plur
slaughter	NOUN	_
sle-	VERB	_
sleeping	VERB	Tense=Pres|VerbForm=Part
sleeve	NOUN	_
slide	VERB	_
slow	NOUN	_
slow	VERB	_
slowly	ADV	_
smart	ADJ	_
sms	NOUN	_
snake	NOUN	_
snatch	VERB	_
soak	VERB	_
soap	NOUN	_
Socio	PROPN	_
socioeconomic	ADJ	_
sociology	NOUN	_
Sociopolitical	PROPN	_
soda	NOUN	_
Sola	PROPN	_
solution	NOUN	_
somehow	ADV	_
someone	PRON	_
song	NOUN	_
sons	NOUN	Number=Plur
sort	VERB	_
sosei	ADV	_
sosoliso	NOUN	_
soul	NOUN	_
sound	VERB	_
source	NOUN	_
South	PROPN	_
Southampton	PROPN	_
Southern	PROPN	_
sp-	VERB	_
Spain	PROPN	_
spark	NOUN	_
spe-	VERB	_
Special	PROPN	_
specifically	ADV	_
speed	NOUN	_
spice	NOUN	_
spices	NOUN	Number=Plur
Spiderman	PROPN	_
spies	NOUN	Number=Plur
spirit	NOUN	_
Spirit	PROPN	_
spirits	NOUN	Number=Plur
spokesperson	NOUN	_
sponsor	VERB	_
spoon	NOUN	_
sport	ADJ	_
sport	NOUN	_
sportology	NOUN	_
sports	NOUN	Number=Plur
spot	NOUN	_
sprinkle	VERB	_
spu-	VERB	_
squad	NOUN	_
st-	NOUN	_
stab	VERB	_
Stadium	PROPN	_
Staff	PROPN	_
stage	NOUN	_
standard	NOUN	_
Star	PROPN	_
starter	NOUN	_
starting	VERB	Tense=Pres|VerbForm=Part
statement	NOUN	_
states	NOUN	Number=Plur
stational	ADJ	_
staunch	ADJ	_
steal	VERB	_
steam	VERB	_
Stephen	PROPN	_
stew	NOUN	_
stick	NOUN	_
stock	NOUN	_
stockfish	NOUN	_
Stoke	PROPN	_
stommy	NOUN	_
stops	VERB	Mood=Ind|Number=Sing|Person=3|Tense=Pres|VerbForm=Fin
Stout	PROPN	_
STP-	PROPN	_
STPP	PROPN	_
stranger	NOUN	_
stream	VERB	_
streetlights	NOUN	Number=Plur
strength	NOUN	_
striker	NOUN	_
stronger	ADJ	Degree=Cmp
stronghold	NOUN	_
strongly	ADV	_
structure	NOUN	_
studied	VERB	Tense=Past|VerbForm=Part
studies	NOUN	Number=Plur
stumble	VERB	_
Suara	PROPN	_
such	ADV	_
Sudan	PROPN	_
sue	VERB	_
sufficient	ADJ	_
suicide	NOUN	_
Sulaiman	PROPN	_
Sule	PROPN	_
sulphuric	ADJ	_
sum	NOUN	_
summer	NOUN	_
Summit	PROPN	_
Sunshine	PROPN	_
Super	PROPN	_
Superman	NOUN	_
SuperSport	PROPN	_
supper	NOUN	_
Supreme	PROPN	_
surely	ADV	_
surfing	VERB	Tense=Pres|VerbForm=Part
suspect	NOUN	_
sweat	NOUN	_
sweep	VERB	_
swimming	VerbForm=Part|Tense=Pres	swim
swimming	NOUN	_
Swiss	ADJ	_
Swiss	PROPN	_
switch	NOUN	_
switch	VERB	_
sy-	NOUN	_
system	NOUN	_
T	NOUN	_
ta	X	_
tab	NOUN	_
table	NOUN	_
taboo	ADJ	_
tackle	VERB	_
tailoring	NOUN	_
Taiwo	PROPN	_
taking	VERB	Tense=Pres|VerbForm=Part
talent	NOUN	_
talented	ADJ	_
tall	ADJ	_
tan	NOUN	_
target	VERB	_
Tarok	PROPN	_
task	NOUN	_
tattasai	NOUN	_
tawon	NOUN	_
tax	NOUN	_
Tea	PROPN	_
tear	NOUN	_
tear	VERB	_
tearing	VERB	Tense=Pres|VerbForm=Part
tears	NOUN	Number=Plur
Tech	PROPN	_
Technical	PROPN	_
Tedida	PROPN	_
teeth	NOUN	Number=Plur
Teheran	NOUN	_
TELCOS	PROPN	_
telegraph	NOUN	_
Telegraph	PROPN	_
Telemundo	NOUN	_
television	NOUN	_
telly	NOUN	_
temper	NOUN	_
temperature	NOUN	_
tempt	VERB	_
tempted	VERB	Tense=Past|VerbForm=Part
Ten	PROPN	_
tension	NOUN	_
tenth	ADJ	Degree=Poss|NumType=Ord
tenure	NOUN	_
term	NOUN	_
terms	NOUN	Number=Plur
terror	NOUN	_
Tertiary	PROPN	_
tete	X	_
text	NOUN	_
textbook	NOUN	_
tezapen	NOUN	_
theatre	NOUN	_
their	ADJ	Number=Plur|Poss=Yes|Pers=3|PronType=Pers
Theo	PROPN	_
Theophilllus	PROPN	_
thereabout	ADV	_
these	DET	_
they	PRON	Case=Nom|Number=Plur|Person=3|PronType=Prs
thirt-	NUM	_
Thompson	PROPN	_
thou-	NUM	NumType=Card
threaten	VERB	_
thunder	NOUN	_
Thursday	PROPN	_
ti	X	_
Tiago	PROPN	_
tian	NOUN	_
tiatia	NOUN	_
tick	ADJ	_
tickets	NOUN	Number=Plur
tier	NOUN	_
tight	VERB	_
tii	X	_
Timothy	PROPN	_
tinking	VERB	Tense=Pres|VerbForm=Part
toasted	VERB	Tense=Past|VerbForm=Part
toaster	NOUN	_
toilet	NOUN	_
told	VERB	Mood=Ind|Tense=Past|VerbForm=Fin
tomato	NOUN	_
took	VERB	Mood=Ind|Tense=Past|VerbForm=Fin
toothbrush	NOUN	_
topics	NOUN	Number=Plur
torchlight	NOUN	_
torchlight	VERB	_
tori	NOUN	_
torn	VERB	Tense=Past|VerbForm=Part
toss	VERB	_
Total	PROPN	_
tough	ADJ	_
tought	VERB	Tense=Past|VerbForm=Part
tour	NOUN	_
tourism	NOUN	_
towards	ADP	_
Toyibat	PROPN	_
Toyota	PROPN	_
Toyyibat	PROPN	_
trade	NOUN	_
Trade	PROPN	_
tradition	NOUN	_
traditional	ADJ	_
traditionalists	NOUN	Number=Plur
transformer	NOUN	_
translate	VERB	_
transmission	NOUN	_
trap	VERB	_
tre-	NOUN	_
treasure	VERB	_
treatment	NOUN	_
tree	NOUN	_
trends	NOUN	Number=Plur
trendy	ADJ	_
tri-	NOUN	_
trip	VERB	_
Tripartite	PROPN	_
Triple	PROPN	_
troops	NOUN	Number=Plur
troughout	NOUN	_
trow	VERB	_
truly	ADV	_
trying	VERB	Tense=Pres|VerbForm=Part
Tuesdays	NOUN	Number=Plur
tun	X	_
Tunde	PROPN	_
tune	NOUN	_
turkey	NOUN	_
Turkey	PROPN	_
tush	ADJ	_
tuwo	NOUN	_
twenty-fourth	ADJ	Degree=Poss|NumType=Ord
typical	ADJ	_
typically	ADV	_
typing	VERB	Tense=Pres|VerbForm=Part
tyre	NOUN	_
U	NOUN	_
Uche	PROPN	_
Uchena	PROPN	_
Udi	PROPN	_
Udoh	PROPN	_
ugu	NOUN	_
ugwu	NOUN	_
UHF	PROPN	_
Uhrobo	PROPN	_
uhum	INTJ	_
UI	PROPN	_
UJ	PROPN	_
Ujendu	PROPN	_
Ujewa	PROPN	_
UK	NOUN	_
Uka	PROPN	_
Ukwuani	PROPN	_
UME	PROPN	_
Umi	PROPN	_
Umuahia	PROPN	_
Umukpara	NOUN	_
understanding	NOUN	_
undying	ADJ	_
Unicem	PROPN	_
Unified	PROPN	_
Unit	PROPN	_
unit	PROPN	_
United	PROPN	_
universities	NOUN	Number=Plur
unknown	ADJ	_
unlike	ADP	_
upgrade	VERB	_
uphold	VERB	_
upstairs	ADV	_
users	NOUN	Number=Plur
UTME	PROPN	_
Uwani	PROPN	_
Uyo	PROPN	_
vacation	NOUN	_
valuable	ADJ	_
varieties	NOUN	Number=Plur
vehicle	NOUN	_
venue	NOUN	_
verse	NOUN	_
version	NOUN	_
Vice	PROPN	_
Vick	PROPN	_
victim	NOUN	_
victims	NOUN	Number=Plur
victory	NOUN	_
vigil	NOUN	_
villa	NOUN	_
visa	NOUN	_
viscosity	NOUN	_
visitors	NOUN	Number=Plur
vital	ADJ	_
volume	NOUN	_
voter's	NOUN	_
Wa-	PROPN	_
wack	VERB	_
wage	NOUN	_
wahm	NOUN	_
wahn	NOUN	_
waking	VERB	Tense=Pres|VerbForm=Part
walahi	INTJ	_
Walcott	PROPN	_
walk	VERB	_
walka	VERB	_
walking	VERB	Tense=Pres|VerbForm=Part
Walter	PROPN	_
wanna	VERB	_
war	NOUN	_
Warner	PROPN	_
washed	VERB	Tense=Past|VerbForm=Part
wasted	NOUN	Tense=Past|VerbForm=Part
waterleaf	NOUN	_
watermelon	NOUN	_
wayo	NOUN	_
we-	PRON	PronType=Int
weak	ADJ	_
wealth	NOUN	_
weavon	NOUN	_
website	NOUN	_
Wednesdays	PROPN	Number=Plur
Weeka	PROPN	_
weigh	VERB	_
welcome	VERB	_
Wepawanu	PROPN	_
were	AUX	Mood=Ind|Tense=Past|VerbForm=Fin
we're	AUX	_
western	ADJ	_
what's	PRON	PronType=Int
WhatsApp	PROPN	_
whereas	SCONJ	_
whistle	ADJ	_
whistle	NOUN	_
wi-	ADP	_
widin	ADP	_
widows	NOUN	Number=Plur
Wike	PROPN	_
Will	PROPN	_
willy	ADV	_
Wilson	PROPN	_
Winifred	PROPN	_
wire	NOUN	_
wiring	NOUN	_
wise	ADJ	_
wishes	NOUN	Number=Plur
withdrawal	NOUN	_
within	ADP	_
wizard	NOUN	_
wo	INTJ	_
wole	X	_
wolu	X	_
wom-	NOUN	_
Women	PROPN	_
won	X	_
won't	AUX	_
wooden	ADJ	_
wor-	VERB	_
words	NOUN	Number=Plur
working	VERB	Tense=Pres|VerbForm=Part
Works	PROPN	_
World	PROPN	_
worm	NOUN	_
worrying	VERB	Tense=Pres|VerbForm=Part
worship	VERB	_
worth	ADJ	_
worth	VERB	_
wow	INTJ	_
wowo	ADJ	_
wrap	VERB	_
wrapper	NOUN	_
Wright	PROPN	_
writing	VERB	Tense=Pres|VerbForm=Part
wu-	X	_
Wuse	PROPN	_
www	PROPN	_
ya	ADJ	_
yab	VERB	_
Yaba	PROPN	_
yafun	ADV	_
yah	INTJ	_
Yahaya	PROPN	_
yahoo	NOUN	_
yama	NOUN	_
yan	X	_
yarning	NOUN	_
yarnings	NOUN	Number=Plur
yarns	NOUN	Number=Plur
yauwa	INTJ	_
yea	INTJ	_
Year	PROPN	_
yearly	ADV	_
yeh	INTJ	_
Yenagoa	PROPN	_
yet	ADJ	_
Yoruba	ADJ	_
Yoruba	PROPN	_
yousef	PRON	_
Youth	PROPN	_
youths	NOUN	Number=Plur
Yunusa	PROPN	_
Yusuf	PROPN	_
za	X	_
zaga	X	_
Zakari	PROPN	_
Zee	NOUN	_
zero	NOUN	_
zero	NUM	NumType=Card
zero	NUM	_
Zidane	PROPN	_
Zimbabwe	PROPN	_
Zimbabwe's	PROPN	_
Zinedine	PROPN	_
zones	NOUN	Number=Plur
zuga	VERB	_
zugi	X	_
corporate	ADJ	_
spe-	ADJ	_
pro-	NOUN	_
republic	NOUN	_
wo-	NOUN	_
one	NUM	_
ya	PART	_
American	PROPN	_
Assemblies	PROPN	_
Chinese	PROPN	_
ST-	PROPN	_
Zee	PROPN	_
Zem	PROPN	_
co-	VERB	_
ara	X	_
pele	X	_
ya 	X	_
accord	VERB	_
allowance	NOUN	_
	NOUN	_
artwork	NOUN	_
bean	NOUN	_
being	NOUN	_
boarder	NOUN	_
Boy	NOUN	_
child 	NOUN	_
colleague 	NOUN	_
control 	VERB	_
cook 	VERB	_
corner 	NOUN	_
cornflake 	NOUN	_
corper 	NOUN	_
customer 	NOUN	_
cutter 	NOUN	_
daughter 	NOUN	_
dem 	NOUN	_
deir 	NOUN	_
demself 	NOUN	_
deodorant	NOUN	_
dese 	NOUN	_
doctor 	NOUN	_
dose 	NOUN	_
drink 	NOUN	_
elder	NOUN	_
end 	VERB	_
eye 	NOUN	_
fee 	NOUN	_
female 	NOUN	_
follower 	NOUN	_
friend 	NOUN	_
germ	NOUN	_
get 	VERB	_
girl 	NOUN	_
give 	VERB	_
go 	VERB	_
governor 	NOUN	_
hand 	NOUN	_
hour 	NOUN	_
house 	NOUN	_
ingredient 	NOUN	_
jean	NOUN	_
job 	NOUN	_
kid 	NOUN	_
lecture 	NOUN	_
link 	NOUN	_
make 	VERB	_
marriage 	NOUN	_
mass 	NOUN	_
master 	NOUN	_
matter 	NOUN	_
mean 	NOUN	_
member 	NOUN	_
man 	NOUN	_
mention	VERB	_
message 	NOUN	_
minute 	NOUN	_
moder 	NOUN	_
month 	NOUN	_
mother 	NOUN	_
motor 	NOUN	_
name 	NOUN	_
neighbour 	NOUN	_
occupy	VERB	_
oda	NOUN	_
okada 	NOUN	_
one 	NOUN	_
onion 	NOUN	_
opportunity 	NOUN	_
oursef 	NOUN	_
oursefs	NOUN	_
paper 	NOUN	_
parent 	NOUN	_
pertain 	VERB	_
place 	NOUN	_
player 	NOUN	_
politician 	NOUN	_
pray 	VERB	_
predators	NOUN	_
professor 	NOUN	_
programme 	NOUN	_
promise 	NOUN	_
proof 	NOUN	_
reason	NOUN	_
school 	NOUN	_
see 	VERB	_
sell 	VERB	_
shop 	VERB	_
shop 	NOUN	_
sibling 	NOUN	_
sin 	NOUN	_
sister 	NOUN	_
soldier 	NOUN	_
speak 	VERB	_
sponsor 	NOUN	_
stay 	VERB	_
story 	NOUN	_
student 	NOUN	_
subject	NOUN	_
Sunday	NOUN	_
talk 	VERB	_
teacher 	NOUN	_
teach 	VERB	_
technician 	NOUN	_
tell 	VERB	_
di 	NOUN	_
ting 	NOUN	_
tink 	VERB	_
tool 	NOUN	_
truck 	NOUN	_
twin 	NOUN	_
university 	NOUN	_
vitamin	NOUN	_
waste 	VERB	_
week 	NOUN	_
wesef 	NOUN	_
window 	NOUN	_
witness 	NOUN	_
woman 	NOUN	_
worker 	NOUN	_
year 	NOUN	_
American	NOUN	_
attempt	VERB	_
back	VERB	_
bag	NOUN	_
barracks	NOUN	_
base	VERB	_
border	NOUN	_
boxer	NOUN	_
branch	NOUN	_
bribe	VERB	_
buck	NOUN	_
caller	NOUN	_
chips	NOUN	_
clothes	NOUN	_
crumble	NOUN	_
dance	NOUN	_
debenture	NOUN	_
discourage	VERB	_
dishearten	VERB	_
dollar	NOUN	_
double	VERB	_
dull	VERB	_
embarrass	VERB	_
e-service	NOUN	_
euro	NOUN	_
foot	NOUN	_
figure	NOUN	_
fraction	NOUN	_
Friday	NOUN	_
fries	NOUN	_
frustrate	VERB	_
garment	NOUN	_
guard	NOUN	_
guideline	NOUN	_
hand	VERB	_
hooligan	NOUN	_
horse	NOUN	_
hot	VERB	_
illusion	NOUN	_
instrumentalist	NOUN	_
interview	NOUN	_
investor	NOUN	_
joke	VERB	_
kin	NOUN	_
liter	NOUN	_
medical	NOUN	_
million	NOUN	_
Monday	NOUN	_
monger	NOUN	_
nigger	NOUN	_
odds	NOUN	_
offence	NOUN	_
officer	NOUN	_
passenger	NOUN	_
pillar	NOUN	_
pound	NOUN	_
preside	VERB	_
professional	NOUN	_
proverb	VERB	_
pupil	NOUN	_
rash	NOUN	_
resource	NOUN	_
Saturday	NOUN	_
savings	NOUN	_
scare	VERB	_
scissor	NOUN	_
second	NOUN	_
shot	NOUN	_
slang	NOUN	_
spy	NOUN	_
streelight	NOUN	_
study	VERB	_
surf	VERB	_
tooth	NOUN	_
deir	NOUN	_
traditionalist	NOUN	_
troop	NOUN	_
Tuesday	NOUN	_
type	VERB	_
user	NOUN	_
variety	NOUN	_
Wednesday	NOUN	_
widow	NOUN	_
wish	NOUN	_
zone	NOUN	_
&//	PUNCT	_
//[eng	PUNCT	_
?//)	PUNCT	_
?//[yor	PROPN	_
||[eng	PUNCT	_
eng]//	PUNCT	_
eng//]	PUNCT	_
eng]//[eng	PUNCT	_
eng]?//	PUNCT	_
eng]]//	PUNCT	_
eng]]]//	SCONJ	_
eng]|c	NOUN	_
eng]<	VERB	_
hau]//	PUNCT	_
hau]<	ADJ	_
haus]	PUNCT	_
[haus	PUNCT	_
igb]?//	PUNCT	_
yor?//]	PUNCT	_
yor]//	PUNCT	_
