fe-	X	_
luc	PROPN	_
k	NOUN	_
jewelries	NOUN	_
sab	VERB	_
_	_	_
mgbe	X	_
gasi	X	_
uwa	X	_
eziokwu	X	_
ga-	NOUN	_
inf	X	_
Yesterday	PROPN	_
Ninety	PROPN	_
[ar	PUNCT	_
ar]	PUNCT	_
Olorun	PROPN	_
millilon	NOUN	_
nearby	ADJ	_
oloun	X	_
Matriculations	PROPN	_
PM	ADV	_
Ninety-six	NUM	_
spinnach	NOUN	_
Proverb	PROPN	_
accomodation	NOUN	_
Simbo	PROPN	_
whats	PART	_
fresher	NOUN	_
knicker	NOUN	_
came	VERB	_
regime	NOUN	_
Odetola	PROPN	_
ga-	XX	_
simple	ADJ	_
millon	NOUN	NumType=Card
occur	VERB	_
[Eng	PUNCT	_
Eng]	PUNCT	_
afiafherebo	NOUN	_
wit-	X	_
liablity	NOUN	_
formalin	NOUN	_
sulphric	ADJ	_
sulphiric	ADJ	_
tipper	NOUN	_
tippers	NOUN	_
St	PROPN	_
kepukepu	NOUN	_
knak	VERB	_
On	ADP	_
Child	NOUN	_
Dialysis	NOUN	_
Upper	PROPN	_
shh	INTJ	_
untill	ADP	_
rehearse	VERB	_
Gen	XX	_
p-	XX	_
becauase	SCONJ	_
restructring	NOUN	_
Avian	PROPN	_
Flu	PROPN	_
Avian	NOUN	_
Flu	PUNCT	_
Zimbambwe	PROPN	_
[Igb	PUNCT	_
Igb]	PUNCT	_
Representate	PROPN	_
FRIS	VERB	_
nai	XX	_
Allordiah	PROPN	_
arrangy	NOUN	_
assessement	NOUN	_
Aviation	PROPN	_
kalapotedly	ADV	_
On	PROPN	_
Lighter	PROPN	_
Note	PROPN	_
Skecity	X	_
simple	NOUN	_
p-	X	_
universties	NOUN	_
Haba	PROPN	_
